Updated On,State,TotalDosesAdministered,TotalSessionsConducted,TotalSites ,FirstDoseAdministered,SecondDoseAdministered,Male,Female,Transgender,Covaxin,CoviShield,SputnikV,AEFI,18_45_years,45_60_years,60_+_years,Total_Individuals_Vaccinated
16-03-2021,Bihar,1521806,246050,1207,1197777,324029,566198,631396,183,65440,1456366,,123,336619,402578,457893,1197777
17-03-2021,Bihar,1633471,222900,1070,1299718,333753,624902,674639,177,72439,1561032,,125,339861,421360,537801,1299718
18-03-2021,Bihar,1709461,245950,1197,1364201,345260,659869,704150,182,74135,1635326,,128,343727,435055,584707,1364201
19-03-2021,Bihar,1781915,219450,1104,1427007,354908,693990,732832,185,77749,1704166,,132,347282,448601,630405,1427007
20-03-2021,Bihar,1868362,244230,1261,1502913,365449,734590,768144,179,81766,1786596,,141,351126,465236,685818,1502913
21-03-2021,Bihar,1893344,25100,158,1526471,366873,746582,779709,180,82392,1810952,,141,352088,469883,703764,1526471
22-03-2021,Bihar,1960951,259150,1367,1588734,372217,779567,808985,182,83030,1877921,,142,354396,481201,752393,1588734
23-03-2021,Bihar,2090147,309250,1692,1708266,381881,841340,866742,184,87057,2003090,,143,358917,503564,845017,1708266
24-03-2021,Bihar,2199108,330750,1797,1810293,388815,894173,915930,190,91237,2107871,,144,362540,522394,924583,1810293
25-03-2021,Bihar,2326623,345050,2002,1931442,395181,954918,976327,197,92898,2233725,,145,365874,545559,1019223,1931442
26-03-2021,Bihar,2440263,319450,2076,2039444,400819,1009347,1029889,208,95536,2344727,,145,368723,566393,1103528,2039444
27-03-2021,Bihar,2555647,309630,2019,2150425,405222,1065255,1084956,214,97860,2457787,,154,371142,588886,1189577,2150425
28-03-2021,Bihar,2584553,140400,950,2179032,405521,1079393,1099424,215,98243,2486310,,154,371545,595414,1211245,2179032
29-03-2021,Bihar,2587193,57950,276,2181647,405546,1080620,1100812,215,98253,2488940,,154,371559,596063,1213196,2181647
30-03-2021,Bihar,2632950,287050,1719,2225891,407059,1103249,1122425,217,99511,2533439,,156,372310,606035,1246710,2225891
31-03-2021,Bihar,2739610,354550,2093,2326918,412692,1155192,1171501,225,103764,2635846,,158,374331,629323,1322413,2326918
01-04-2021,Bihar,2851813,377050,2284,2433633,418180,1209360,1224039,234,109343,2742470,,159,376501,676552,1379721,2433633
02-04-2021,Bihar,3064854,354600,2122,2638486,426368,1311120,1327112,254,123987,2940867,,159,380026,776394,1481196,2638486
03-04-2021,Bihar,3195814,313140,2040,2763236,432578,1374291,1388678,267,137266,3058548,,159,382249,840257,1539850,2763236
04-04-2021,Bihar,3346839,356850,1683,2908130,438709,1447277,1460574,279,164103,3182736,,159,384237,917123,1605883,2908130
05-04-2021,Bihar,3478610,450951,2517,3031775,446835,1509853,1521629,293,182884,3295726,,160,384579,980809,1665492,3031775
06-04-2021,Bihar,3676143,466920,2674,3217315,458828,1601821,1615186,308,207945,3468198,,163,385142,1075533,1755738,3217315
07-04-2021,Bihar,3981969,310600,1958,3500712,481257,1743992,1756381,339,222226,3759743,,163,385885,1223179,1890738,3500712
08-04-2021,Bihar,4165803,375950,2107,3663711,502092,1826420,1836932,359,226278,3939525,,165,386365,1311312,1965119,3663711
09-04-2021,Bihar,4233637,399850,2036,3721775,511862,1857449,1863961,365,228683,4004954,,166,386719,1343043,1991099,3721775
10-04-2021,Bihar,4491227,529101,3056,3953983,537244,1974484,1979089,410,230671,4260556,,167,387622,1468809,2096637,3953983
11-04-2021,Bihar,4744755,585150,3164,4188252,556503,2091666,2096134,452,232742,4512013,,169,388394,1593789,2205146,4188252
12-04-2021,Bihar,4952445,496300,2720,4372599,579846,2185595,2186521,483,234507,4717938,,169,389565,1690053,2292054,4372599
13-04-2021,Bihar,5049345,395852,2219,4456899,592446,2229729,2226680,490,245029,4804316,,171,390325,1734938,2330711,4456899
14-04-2021,Bihar,5225646,516200,2886,4608655,616991,2310036,2298095,524,255369,4970277,,171,391571,1817501,2398651,4608655
15-04-2021,Bihar,5352860,465760,2658,4714910,637950,2367479,2346892,539,269422,5083438,,172,393566,1874499,2445909,4714910
16-04-2021,Bihar,5426287,391270,2168,4774916,651371,2400394,2373969,553,281410,5144877,,173,394858,1907005,2472117,4774916
17-04-2021,Bihar,5578006,432820,2612,4895185,682821,2467117,2427501,567,293703,5284303,,174,397741,1971174,2525331,4895185
18-04-2021,Bihar,5686374,476580,2749,4984400,701974,2516039,2467783,578,301567,5384807,,174,399068,2018767,2565629,4984400
19-04-2021,Bihar,5836677,509910,2984,5099038,737639,2579369,2519074,595,310307,5526370,,175,401779,2078558,2617763,5099038
20-04-2021,Bihar,5964087,501070,2974,5195367,768720,2633442,2561314,611,319116,5644971,,175,403800,2129587,2661047,5195367
21-04-2021,Bihar,6057111,452700,2744,5265128,791983,2672276,2592230,622,324892,5732219,,176,405315,2167926,2690953,5265128
22-04-2021,Bihar,6169648,480430,3012,5344307,825341,2716504,2627167,636,332830,5836818,,177,407334,2211450,2724578,5344307
23-04-2021,Bihar,6270782,448930,2793,5415848,854934,2756624,2658582,642,340190,5930592,,178,409756,2251242,2753897,5415848
24-04-2021,Bihar,6362064,405540,2613,5480243,881821,2792909,2686679,655,347867,6014197,,179,412086,2287882,2779315,5480243
25-04-2021,Bihar,6437127,364600,2201,5534535,902592,2823940,2709931,664,352127,6085000,,179,413525,2318481,2801554,5534535
26-04-2021,Bihar,6557857,475830,2970,5615151,942706,2868822,2745654,675,358812,6199045,,179,416173,2362927,2835067,5615151
27-04-2021,Bihar,6661790,470380,2991,5686449,975341,2909244,2776519,686,364993,6296797,,179,558059,2263202,2864197,5686449
28-04-2021,Bihar,6761471,405170,2538,5752082,1009389,2946062,2805327,693,370807,6390664,,179,562159,2298645,2890276,5752082
29-04-2021,Bihar,6869722,462150,2928,5821599,1048123,2985176,2835715,708,377281,6492441,,180,567181,2336696,2916965,5821599
30-04-2021,Bihar,6967492,437150,2787,5881859,1085633,3019397,2861742,720,385347,6582145,,180,572437,2369838,2938810,5881859
01-05-2021,Bihar,7047770,360750,2328,5928725,1119045,3046770,2881219,736,391991,6655779,,180,577355,2395519,2955071,5928725
02-05-2021,Bihar,7110550,330208,1981,5965407,1145143,3067765,2896899,743,396195,6714355,,180,574826,2421841,2968034,5965407
03-05-2021,Bihar,7233171,514550,2992,6027693,1205478,3103314,2923627,752,403840,6829331,,182,580332,2455247,2991407,6027693
04-05-2021,Bihar,7359866,520230,3101,6092049,1267817,3140680,2950603,766,413470,6946396,,183,587086,2489208,3015043,6092049
05-05-2021,Bihar,7475869,427600,2575,6150797,1325072,3175047,2974968,782,422099,7053770,,183,594498,2519250,3036336,6150797
06-05-2021,Bihar,7604097,433200,2713,6212706,1391391,3211123,3000791,792,429065,7175032,,183,602304,2551552,3058132,6212706
07-05-2021,Bihar,7698767,384100,2454,6261291,1437476,3239886,3020602,803,438491,7260276,,183,609383,2576576,3074612,6261291
08-05-2021,Bihar,7782756,551651,3138,6304398,1478358,3265339,3038250,809,449731,7333025,,183,616430,2599035,3088208,6304398
09-05-2021,Bihar,7905698,520915,2864,6411990,1493708,3339393,3071762,835,456010,7449688,,183,707085,2610086,3094085,6411990
10-05-2021,Bihar,8108459,539580,2913,6552924,1555535,3430766,3121277,881,466854,7641605,,183,802922,2639391,3109725,6552924
11-05-2021,Bihar,8289734,434502,2503,6669849,1619885,3503674,3165269,906,478929,7810805,,183,868582,2672158,3128150,6669849
12-05-2021,Bihar,8410850,489860,2759,6771938,1638912,3568594,3202406,938,518121,7892729,,183,938215,2693521,3139173,6771938
13-05-2021,Bihar,8568033,486212,2554,6907777,1660256,3656030,3250774,973,556206,8011827,,183,1042527,2714458,3149690,6907777
14-05-2021,Bihar,8713263,433151,2193,7038183,1675080,3739345,3297823,1015,578715,8134548,,183,1149475,2730423,3157100,7038183
15-05-2021,Bihar,8869524,472610,2588,7180068,1689456,3829966,3349038,1064,593607,8275917,,185,1268600,2745972,3164192,7180068
16-05-2021,Bihar,8994996,433121,2182,7303994,1691002,3910056,3392834,1104,603397,8391599,,185,1383132,2752667,3166777,7303994
17-05-2021,Bihar,9108969,451575,2281,7411900,1697069,3979595,3431162,1143,624474,8484495,,186,1473613,2765172,3171599,7411900
18-05-2021,Bihar,9188143,385592,1939,7483076,1705067,4024664,3457245,1167,653650,8534493,,186,1523201,2780255,3178054,7483076
19-05-2021,Bihar,9244503,330923,1574,7533234,1711269,4055849,3476204,1181,676443,8568060,,188,1552616,2794867,3184165,7533234
20-05-2021,Bihar,9364319,472093,2018,7649684,1714635,4130602,3517849,1233,687077,8677242,,189,1657827,2802664,3187484,7649684
21-05-2021,Bihar,9461804,415898,1866,7740228,1721576,4186389,3552576,1263,703439,8758365,0,190,1727357,2817403,3193704,7740228
22-05-2021,Bihar,9521984,448969,2007,7792417,1729567,4218398,3572736,1283,720880,8801104,0,190,1758246,2832198,3200164,7792417
23-05-2021,Bihar,9680319,586240,2413,7946124,1734195,4314767,3629998,1359,730210,8950109,0,190,1898012,2841540,3204640,7946124
24-05-2021,Bihar,9866975,611371,2444,8126351,1740624,4428170,3696735,1446,742073,9124902,0,190,2061663,2853123,3209492,8126351
25-05-2021,Bihar,9988331,526839,2259,8240377,1747954,4500545,3738337,1495,755929,9232402,0,190,2161959,2862907,3213320,8240377
26-05-2021,Bihar,10065594,603960,2477,8310987,1754607,4545683,3763780,1524,767758,9297836,0,191,2208411,2880235,3220094,8310987
27-05-2021,Bihar,10117955,527748,2136,8358232,1759723,4574895,3781803,1534,776108,9341847,0,191,2233476,2895668,3226816,8358232
28-05-2021,Bihar,10151853,481999,1891,8387278,1764575,4592530,3793203,1545,782672,9369181,0,191,2246216,2906760,3232021,8387278
29-05-2021,Bihar,10204573,543570,1931,8431414,1773159,4619004,3810857,1553,795116,9409457,0,191,2261778,2926372,3240965,8431414
30-05-2021,Bihar,10247415,479815,1751,8467861,1779554,4639735,3826562,1564,804259,9443156,0,191,2270460,2945260,3249828,8467861
31-05-2021,Bihar,10307600,593794,2052,8516097,1791503,4667304,3847222,1571,817845,9489755,0,191,2281461,2970872,3261439,8516097
01-06-2021,Bihar,10366689,576427,2034,8563603,1803086,4693979,3868046,1578,830835,9535854,0,193,2289937,2996868,3274463,8563603
02-06-2021,Bihar,10424975,560233,2062,8612656,1812319,4720745,3890328,1583,841901,9583074,0,195,2297889,3024347,3288064,8612656
03-06-2021,Bihar,10585288,794305,2707,8764409,1820879,4812092,3950693,1624,865681,9719607,0,196,2406210,3053322,3302386,8764409
04-06-2021,Bihar,10772252,797962,2715,8941673,1830579,4919926,4020049,1698,891581,9880671,0,196,2543344,3080223,3315420,8941673
05-06-2021,Bihar,10922525,805747,2834,9083469,1839056,5004520,4077199,1750,916993,10005532,0,196,2639165,3110897,3330618,9083469
06-06-2021,Bihar,11030034,680772,2514,9183267,1846767,5062126,4119362,1779,944593,10085441,0,197,2699664,3136884,3343857,9183267
07-06-2021,Bihar,11134737,756146,2563,9277636,1857101,5115446,4160390,1800,977551,10157186,0,197,2749119,3166960,3358635,9277636
08-06-2021,Bihar,11231592,720074,2433,9362801,1868791,5162706,4198274,1821,1012409,10219183,0,197,2786932,3198367,3374528,9362801
09-06-2021,Bihar,11409331,844921,2772,9530621,1878710,5264974,4263769,1878,1035635,10373696,0,197,2912293,3227046,3388113,9530621
10-06-2021,Bihar,11599819,954916,2934,9712352,1887467,5378257,4332166,1929,1053972,10545847,0,197,3050937,3256472,3401588,9712352
11-06-2021,Bihar,11778969,833367,2795,9881658,1897311,5475709,4403969,1980,1065775,10713194,0,197,3172385,3289515,3416257,9881658
12-06-2021,Bihar,11938798,916193,2883,10032415,1906383,5559406,4470981,2028,1075681,10863117,0,199,3268796,3326163,3433870,10032415
13-06-2021,Bihar,12032029,684871,2320,10119417,1912612,5606378,4511002,2037,1081894,10950135,0,199,3314823,3353567,3447416,10119417
14-06-2021,Bihar,12133333,720902,2433,10210633,1922700,5655062,4553530,2041,1091206,11042127,0,199,3355696,3386996,3464291,10210633
15-06-2021,Bihar,12205407,687269,2335,10273357,1932050,5687518,4583793,2046,1099531,11105876,0,199,3377936,3412993,3478757,10273357
16-06-2021,Bihar,12716811,2243423,5104,10763130,1953681,5958003,4802979,2148,1124634,11592177,0,200,3798531,3460827,3499791,10763130
17-06-2021,Bihar,12982413,1348561,2773,10995411,1987002,6085226,4907985,2200,1163058,11819355,0,200,3980008,3495331,3515944,10995411
18-06-2021,Bihar,13174680,1011081,2585,11158741,2015939,6171990,4984520,2231,1212817,11961863,0,200,4087195,3532044,3535259,11158741
19-06-2021,Bihar,13509656,1633791,3584,11471642,2038014,6346029,5123326,2287,1266734,12242922,0,201,4341451,3571286,3554431,11471642
20-06-2021,Bihar,13680378,1272921,2197,11630826,2049552,6436064,5192448,2314,1297687,12382691,0,201,4469114,3592438,3564700,11630826
21-06-2021,Bihar,14235058,3478224,4256,12161634,2073424,6726542,5432655,2437,1387886,12847172,0,201,4888908,3666729,3601112,12161634
22-06-2021,Bihar,14642396,2051895,3178,12546864,2095532,6931464,5612891,2509,1484822,13157574,0,201,5181059,3728106,3632662,12546864
23-06-2021,Bihar,14978417,2053458,2763,12863306,2115111,7101980,5758762,2564,1547162,13431255,0,201,5418790,3780400,3658926,12863306
24-06-2021,Bihar,15264572,1872290,2433,13127210,2137362,7241294,5883304,2612,1612751,13651821,0,201,5613532,3825493,3682864,13127210
25-06-2021,Bihar,15512516,2273753,1956,13355865,2156651,8537977,6971740,2799,1697897,13814612,7,202,6280272,4614251,4617993,13355865
26-06-2021,Bihar,15683198,1437449,1703,13508016,2175182,8630298,7050060,2840,1742229,13940825,144,205,6395796,4649335,4638067,13508016
27-06-2021,Bihar,15744915,612942,752,13562883,2182032,8663107,7078958,2850,1759614,13985022,279,206,6435823,4662823,4646269,13562883
28-06-2021,Bihar,15802730,784023,800,13608219,2194511,8694847,7105022,2861,1777820,14024554,356,206,6470407,4677013,4655310,13608219
29-06-2021,Bihar,15856079,776711,706,13650265,2205814,8723574,7129602,2903,1794776,14060877,426,206,6503030,4690315,4662734,13650265
30-06-2021,Bihar,15899022,796774,782,13683539,2215483,8746748,7149362,2912,1805950,14092595,477,207,6527929,4701907,4669186,13683539
01-07-2021,Bihar,16116113,1733533,1810,13863804,2252309,8864674,7248480,2959,1826132,14289456,525,207,6668208,4753400,4694505,13863804
02-07-2021,Bihar,16716028,2755056,3821,14384051,2331977,9184960,7528013,3055,1850867,14864598,563,207,7061914,4884995,4769119,14384051
03-07-2021,Bihar,17118573,2048581,2715,14723129,2395444,9394010,7721407,3156,1870072,15247918,583,208,7315692,4979999,4822882,14723129
04-07-2021,Bihar,17255736,1000484,980,14835284,2420452,9465222,7787329,3185,1880704,15374449,583,208,7401543,5013336,4840857,14835284
05-07-2021,Bihar,17384095,1004852,1194,14935067,2449028,9531480,7849401,3214,1890542,15492970,583,208,7476640,5046211,4861244,14935067
06-07-2021,Bihar,17526845,1026556,1146,15046903,2479942,9607873,7915722,3250,1897811,15628446,588,208,7562351,5082969,4881525,15046903
