Updated On,State,TotalDosesAdministered,TotalSessionsConducted,TotalSites ,FirstDoseAdministered,SecondDoseAdministered,Male,Female,Transgender,Covaxin,CoviShield,SputnikV,AEFI,18_45_years,45_60_years,60_+_years,Total_Individuals_Vaccinated
16-03-2021,Chandigarh,49179,7000,49,42234,6945,27417,14817,0,0,49179,,48,13462,13318,15449,42234
17-03-2021,Chandigarh,57449,7300,49,50040,7409,31679,18360,1,0,57449,,49,13705,14342,21988,50040
18-03-2021,Chandigarh,59520,6800,47,51658,7862,32583,19074,1,0,59520,,50,13971,14648,23034,51658
19-03-2021,Chandigarh,61642,7100,50,53379,8263,33496,19882,1,0,61642,,54,14204,15017,24153,53379
20-03-2021,Chandigarh,63645,6700,46,54986,8659,34335,20650,1,0,63645,,55,14453,15378,25149,54986
21-03-2021,Chandigarh,63808,1700,11,55144,8664,34418,20725,1,0,63808,,55,14471,15420,25247,55144
22-03-2021,Chandigarh,65746,6900,48,56588,9158,35201,21386,1,0,65746,,56,14665,15739,26178,56588
23-03-2021,Chandigarh,67392,7200,50,57782,9610,35877,21904,1,0,67392,,59,14866,16046,26864,57782
24-03-2021,Chandigarh,68959,7100,50,58992,9967,36577,22414,1,0,68959,,60,15048,16286,27652,58992
25-03-2021,Chandigarh,70827,7400,52,60519,10308,37415,23103,1,0,70827,,60,15377,16608,28527,60519
26-03-2021,Chandigarh,72558,7100,50,61839,10719,38164,23674,1,0,72558,,60,15612,16929,29291,61839
27-03-2021,Chandigarh,74151,6700,46,63168,10983,38829,24338,1,0,74151,,61,15806,17222,30133,63168
28-03-2021,Chandigarh,74257,1700,9,63269,10988,38883,24385,1,0,74257,,61,15818,17257,30187,63269
29-03-2021,Chandigarh,74284,2400,11,63294,10990,38893,24400,1,0,74284,,61,15817,17266,30204,63294
30-03-2021,Chandigarh,76009,8300,51,64574,11435,39599,24974,1,0,76009,,61,15962,17528,31077,64574
31-03-2021,Chandigarh,77711,7200,49,65748,11963,40264,25483,1,0,77711,,62,16118,17720,31903,65748
01-04-2021,Chandigarh,81055,7450,52,68591,12464,41784,26806,1,0,81055,,62,16295,19741,32548,68591
02-04-2021,Chandigarh,84378,7300,50,71565,12813,43392,28172,1,0,84378,,62,16428,21779,33351,71565
03-04-2021,Chandigarh,87837,7100,50,74528,13309,45010,29517,1,0,87837,,63,16659,23828,34034,74528
04-04-2021,Chandigarh,90843,6550,44,77241,13602,46562,30678,1,0,90843,,64,16774,25763,34697,77241
05-04-2021,Chandigarh,94240,7450,53,80058,14182,48139,31918,1,0,94240,,65,16833,27664,35554,80058
06-04-2021,Chandigarh,96011,7650,55,81444,14567,48949,32494,1,0,96011,,65,16869,28578,35990,81444
07-04-2021,Chandigarh,101532,7650,54,85979,15553,51487,34490,2,0,101532,,68,17006,31697,37269,85979
08-04-2021,Chandigarh,105815,7650,55,89382,16433,53305,36075,2,0,105815,,70,17106,33961,38308,89382
09-04-2021,Chandigarh,110149,7650,55,92814,17335,55177,37635,2,0,110149,,72,17357,36239,39211,92814
10-04-2021,Chandigarh,115008,7650,55,96744,18264,57313,39428,3,0,115008,,74,17599,39012,40126,96744
11-04-2021,Chandigarh,118155,7200,50,99484,18671,58812,40669,3,0,118155,,75,17668,40946,40863,99484
12-04-2021,Chandigarh,122941,8200,61,103131,19810,61010,42118,3,0,122941,,76,18086,43229,41809,103131
13-04-2021,Chandigarh,126850,8400,62,106139,20711,62884,43252,3,0,126850,,76,18434,45207,42491,106139
14-04-2021,Chandigarh,130380,8400,63,108803,21577,64430,44370,3,0,130380,,76,18591,46972,43233,108803
15-04-2021,Chandigarh,134563,8800,63,111665,22898,66127,45535,3,0,134563,,76,18805,48843,44010,111665
16-04-2021,Chandigarh,139146,8700,63,114800,24346,68061,46736,3,0,139146,,76,19046,50871,44876,114800
17-04-2021,Chandigarh,143254,7400,56,117734,25520,69799,47931,4,0,143254,,78,19271,52915,45541,117734
18-04-2021,Chandigarh,145600,7200,54,119500,26100,70818,48678,4,0,145600,,78,19325,54112,46056,119500
19-04-2021,Chandigarh,149987,8500,64,122192,27795,72426,49762,4,0,149987,,79,19554,55741,46889,122192
20-04-2021,Chandigarh,154584,8600,65,124937,29647,73970,50962,5,0,154584,,79,19793,57488,47648,124937
21-04-2021,Chandigarh,158565,7900,61,127635,30930,75424,52205,6,0,158565,,80,19916,59288,48423,127635
22-04-2021,Chandigarh,163872,8800,65,130884,32988,77076,53802,6,0,163872,,83,20091,61276,49509,130884
23-04-2021,Chandigarh,169439,8800,66,134397,35042,78944,55447,6,0,169439,,85,20299,63586,50504,134397
24-04-2021,Chandigarh,174721,8300,61,137994,36727,80666,57322,6,0,174721,,86,20523,65962,51501,137994
25-04-2021,Chandigarh,178655,7000,55,140795,37860,82042,58746,7,0,178655,,87,20592,67849,52346,140795
26-04-2021,Chandigarh,184252,8400,64,144305,39947,83896,60402,7,0,184252,,89,20787,70098,53412,144305
27-04-2021,Chandigarh,190041,8400,63,148026,42015,85803,62216,7,0,190041,,89,25283,68142,54593,148026
28-04-2021,Chandigarh,196055,8750,66,151928,44127,87805,64116,7,0,196055,,90,25583,70398,55940,151928
29-04-2021,Chandigarh,201907,8600,65,155689,46218,89628,66054,7,0,201907,,90,25838,72715,57130,155689
30-04-2021,Chandigarh,208489,8700,68,160071,48418,91881,68181,9,0,208489,,92,26169,75482,58412,160071
01-05-2021,Chandigarh,213216,7800,58,163599,49617,93663,69927,9,0,213216,,95,26410,77910,59271,163599
02-05-2021,Chandigarh,215894,6600,51,165617,50277,94656,70952,9,0,215894,,95,26456,79322,59834,165617
03-05-2021,Chandigarh,220462,7200,55,168672,51790,96246,72417,9,0,220462,,96,26768,81198,60701,168672
04-05-2021,Chandigarh,225542,6900,56,172057,53485,98041,74007,9,0,225542,,96,27186,83193,61673,172057
05-05-2021,Chandigarh,230822,6900,55,175618,55204,100003,75605,10,0,230822,,96,27561,85360,62692,175618
06-05-2021,Chandigarh,237473,7000,56,179429,58044,102169,77250,10,0,237473,,96,28127,87600,63697,179429
07-05-2021,Chandigarh,243450,7300,55,183067,60383,104125,78931,11,0,243450,,96,28623,89832,64607,183067
08-05-2021,Chandigarh,250441,7100,57,187445,62996,106338,81095,12,0,250441,,97,29125,92519,65796,187445
09-05-2021,Chandigarh,254612,7400,53,190204,64408,107769,82423,12,0,254612,,97,29413,94243,66543,190204
10-05-2021,Chandigarh,260309,7800,57,193540,66769,109560,83968,12,0,260309,,100,29800,96230,67496,193540
11-05-2021,Chandigarh,265527,7900,58,196808,68719,111293,85502,13,0,265527,,100,30188,98255,68346,196808
12-05-2021,Chandigarh,269353,7900,57,199576,69777,112721,86842,13,0,269353,,101,30553,99875,69126,199576
13-05-2021,Chandigarh,273766,8000,58,202829,70937,114474,88342,13,0,273766,,101,31055,101822,69929,202829
14-05-2021,Chandigarh,278699,8100,58,206572,72127,116552,90007,13,0,278699,,103,32400,103536,70610,206572
15-05-2021,Chandigarh,284834,8300,63,211162,73672,118975,92173,14,0,284834,,103,33953,105722,71458,211162
16-05-2021,Chandigarh,285946,5290,29,212260,73686,119575,92671,14,0,285946,,103,34137,106347,71745,212260
17-05-2021,Chandigarh,290561,11040,63,216622,73939,121957,94650,15,0,290561,,109,36113,108049,72423,216622
18-05-2021,Chandigarh,294430,9670,60,220312,74118,123972,96321,19,0,294430,,109,37918,109384,72968,220312
19-05-2021,Chandigarh,298281,11320,61,224068,74213,126027,98019,22,0,298281,,109,40083,110540,73398,224068
20-05-2021,Chandigarh,302065,10665,65,227748,74317,128028,99693,27,0,302065,,110,42332,111599,73765,227748
21-05-2021,Chandigarh,306407,11470,72,231985,74422,130387,101568,30,0,306407,0,111,45194,112589,74148,231985
22-05-2021,Chandigarh,312342,13510,74,237720,74622,133472,104217,31,0,312342,0,113,49131,113902,74624,237720
23-05-2021,Chandigarh,315428,5705,27,240804,74624,135172,105600,32,0,315428,0,113,51833,114194,74712,240804
24-05-2021,Chandigarh,320496,11811,74,245841,74655,137908,107901,32,0,320496,0,115,55392,115234,75147,245841
25-05-2021,Chandigarh,323442,10780,66,248749,74693,139440,109276,33,0,323442,0,121,57091,116094,75492,248749
26-05-2021,Chandigarh,324892,10320,55,250185,74707,140227,109925,33,0,324892,0,121,57971,116470,75671,250185
27-05-2021,Chandigarh,329825,11710,78,255083,74742,143166,111884,33,0,329825,0,122,61774,117281,75951,255083
28-05-2021,Chandigarh,334628,11803,72,259802,74826,145843,113925,34,0,334628,0,124,65624,117924,76174,259802
29-05-2021,Chandigarh,339601,12392,72,264747,74854,148584,116127,36,0,339601,0,127,69541,118698,76428,264747
30-05-2021,Chandigarh,343466,5830,27,268609,74857,150746,117826,37,0,343466,0,127,73139,118889,76500,268609
31-05-2021,Chandigarh,349507,17087,80,274606,74901,154057,120512,37,0,349507,0,129,78380,119440,76701,274606
01-06-2021,Chandigarh,355311,13795,77,280378,74933,157357,122983,38,0,355311,0,131,83708,119758,76825,280378
02-06-2021,Chandigarh,360794,15120,77,285834,74960,160638,125156,40,0,360794,0,131,88594,120190,76959,285834
03-06-2021,Chandigarh,366709,16560,75,291718,74991,163954,127723,41,0,366709,0,132,93973,120573,77075,291718
04-06-2021,Chandigarh,372191,17075,74,297146,75045,167099,130005,42,0,372191,0,134,98731,121078,77238,297146
05-06-2021,Chandigarh,377873,24455,77,302775,75098,170305,132426,44,0,377873,0,134,103532,121713,77426,302775
06-06-2021,Chandigarh,379943,8840,28,304833,75110,171504,133285,44,0,379943,0,134,105410,121848,77465,304833
07-06-2021,Chandigarh,383353,15320,61,308126,75227,173421,134661,44,0,383353,0,137,107867,122462,77675,308126
08-06-2021,Chandigarh,384919,10885,49,309608,75311,174297,135266,45,0,384919,0,138,108826,122853,77804,309608
09-06-2021,Chandigarh,387273,12190,56,311860,75413,175737,136078,45,0,387273,0,138,110644,123173,77915,311860
10-06-2021,Chandigarh,389571,12357,57,314057,75514,177025,136987,45,0,389571,0,138,112479,123426,78019,314057
11-06-2021,Chandigarh,395515,18515,72,319892,75623,180391,139454,47,0,395515,0,138,117734,123868,78146,319892
12-06-2021,Chandigarh,401380,16216,67,325649,75731,183756,141845,48,0,401380,0,138,122806,124397,78294,325649
13-06-2021,Chandigarh,405319,8765,29,329564,75755,186044,143472,48,0,405319,0,138,126485,124562,78356,329564
14-06-2021,Chandigarh,412175,17983,60,336282,75893,189871,146362,49,0,412175,0,138,132592,125015,78497,336282
15-06-2021,Chandigarh,419164,18265,65,343058,76106,193924,149082,52,0,419164,0,139,138772,125434,78659,343058
16-06-2021,Chandigarh,425495,17840,65,349204,76291,197458,151693,53,0,425495,0,139,144333,125842,78831,349204
17-06-2021,Chandigarh,432584,18780,73,356082,76502,201435,154592,55,0,432584,0,139,150534,126345,78990,356082
18-06-2021,Chandigarh,440585,21015,79,363813,76772,205950,157807,56,100,440485,0,139,157467,126914,79201,363813
19-06-2021,Chandigarh,450057,20585,74,372899,77158,210827,162013,59,270,449787,0,139,165526,127691,79434,372899
20-06-2021,Chandigarh,453577,10810,28,376354,77223,212636,163657,61,350,453227,0,139,168588,128012,79502,376354
21-06-2021,Chandigarh,460426,21219,76,382966,77460,216418,166474,74,390,460036,0,139,174333,128665,79696,382966
22-06-2021,Chandigarh,468436,26471,76,390586,77850,220768,169743,75,482,467954,0,139,180965,129397,79933,390586
23-06-2021,Chandigarh,475527,26120,74,397301,78226,224486,172739,76,593,474934,0,138,186710,130129,80158,397301
24-06-2021,Chandigarh,482326,26172,72,403380,78946,227858,175446,76,788,481538,0,138,191906,130779,80378,403380
25-06-2021,Chandigarh,489480,25945,74,409614,79866,278596,210820,64,989,488491,0,138,216648,156343,116489,409614
26-06-2021,Chandigarh,498862,24000,71,417304,81558,283606,215192,64,1099,497763,0,139,223556,158164,117142,417304
27-06-2021,Chandigarh,504126,24390,57,421745,82381,286432,217630,64,1109,503017,0,139,227353,159275,117498,421745
28-06-2021,Chandigarh,511843,26000,70,427780,84063,290581,221196,66,1138,510705,0,140,232471,161112,118260,427780
29-06-2021,Chandigarh,519880,25884,69,434020,85860,294851,224960,69,1205,518675,0,140,237773,163046,119061,434020
30-06-2021,Chandigarh,526877,26167,70,439301,87576,298570,228236,71,1375,525502,0,141,242263,164845,119769,439301
01-07-2021,Chandigarh,533897,26987,76,444544,89353,302365,231458,74,1444,532453,0,142,246748,166610,120539,444544
02-07-2021,Chandigarh,541103,26012,69,449392,91711,306185,234844,74,1529,539574,0,143,250953,168727,121423,449392
03-07-2021,Chandigarh,551586,29223,71,456634,94952,311609,239901,76,1580,550006,0,143,257260,171936,122390,456634
04-07-2021,Chandigarh,558150,26810,59,461440,96710,315083,242991,76,1580,556570,0,144,261233,173883,123034,461440
05-07-2021,Chandigarh,566601,29430,71,467197,99404,319691,246834,76,1620,564981,0,146,266138,176367,124096,467197
06-07-2021,Chandigarh,574184,31340,76,472038,102146,323916,250188,80,1647,572537,0,146,270343,178743,125098,472038
16-03-2021,Chhattisgarh,1043000,177925,1308,821735,221265,408167,413510,58,282,1042718,,425,283952,242192,295322,821735
17-03-2021,Chhattisgarh,1155353,212850,1563,920994,234359,457860,463067,67,530,1154823,,426,288201,265898,366619,920994
18-03-2021,Chhattisgarh,1233656,215765,1572,987493,246163,490214,497208,71,1001,1232655,,428,291727,281356,414128,987493
19-03-2021,Chhattisgarh,1300911,196542,1429,1043993,256918,517742,526173,78,1346,1299565,,433,294892,296345,452469,1043993
20-03-2021,Chhattisgarh,1382139,216225,1578,1115002,267137,551693,563221,88,1840,1380299,,438,298612,316113,499988,1115002
21-03-2021,Chhattisgarh,1390076,12235,110,1122049,268027,554811,567150,88,1882,1388194,,438,298931,318713,504116,1122049
22-03-2021,Chhattisgarh,1446236,213520,1571,1170273,275963,578165,592017,91,2362,1443874,,441,301314,331838,536830,1170273
23-03-2021,Chhattisgarh,1492021,164640,1223,1207717,284304,596645,610976,96,3090,1488931,,447,304331,344291,558801,1207717
24-03-2021,Chhattisgarh,1536898,187430,1413,1246634,290264,615508,631024,102,3875,1533023,,451,306726,356882,582732,1246634
25-03-2021,Chhattisgarh,1596613,216670,1613,1300439,296174,641263,659068,108,4756,1591857,,454,309366,373628,617148,1300439
26-03-2021,Chhattisgarh,1660268,226085,1655,1359811,300457,669178,690519,114,6409,1653859,,455,311485,392558,655466,1359811
27-03-2021,Chhattisgarh,1773189,256850,1890,1468773,304416,719971,748684,118,7977,1765212,,457,314614,432183,721667,1468773
28-03-2021,Chhattisgarh,1807760,127925,966,1502883,304877,735162,767601,120,8415,1799345,,462,315218,443156,744197,1502883
29-03-2021,Chhattisgarh,1808453,53610,392,1503420,305033,735406,767893,121,8415,1800038,,462,315294,443368,744446,1503420
30-03-2021,Chhattisgarh,1863632,246885,1781,1554803,308829,759383,795288,132,9005,1854627,,464,316484,462857,775146,1554803
31-03-2021,Chhattisgarh,1977918,301970,2152,1662021,315897,809575,852304,142,10585,1967333,,466,318846,508143,834704,1662021
01-04-2021,Chhattisgarh,2113279,358130,2613,1791743,321536,872432,919162,149,12922,2100357,,467,320807,597372,873234,1791743
02-04-2021,Chhattisgarh,2420539,421690,3082,2089641,330898,1013496,1075975,170,18341,2402198,,468,324580,807892,956835,2089641
03-04-2021,Chhattisgarh,2645394,409720,3135,2307001,338393,1117338,1189471,192,21138,2624256,,473,327623,960386,1018655,2307001
04-04-2021,Chhattisgarh,2954955,413840,3090,2607721,347234,1257700,1349795,226,25994,2928961,,481,330028,1178361,1098992,2607721
05-04-2021,Chhattisgarh,3071531,410025,3095,2718779,352752,1309547,1408991,241,29139,3042392,,481,330130,1260473,1127835,2718779
06-04-2021,Chhattisgarh,3170579,428950,3249,2812713,357866,1353760,1458701,252,31947,3138632,,483,330295,1329693,1152384,2812713
07-04-2021,Chhattisgarh,3399416,387045,3028,3031106,368310,1457287,1573544,275,35471,3363945,,489,330433,1492066,1208268,3031106
08-04-2021,Chhattisgarh,3705558,487780,3704,3322112,383446,1594896,1726906,310,37403,3668155,,493,330693,1707068,1284011,3322112
09-04-2021,Chhattisgarh,3935158,487648,3712,3540293,394865,1698686,1841263,344,38895,3896263,,496,331631,1867981,1340339,3540293
10-04-2021,Chhattisgarh,4127809,442680,3513,3721410,406399,1786056,1934995,359,39557,4088252,,497,332570,2001414,1387082,3721410
11-04-2021,Chhattisgarh,4303664,468555,3661,3888257,415407,1867373,2020501,383,40226,4263438,,500,333413,2125631,1428868,3888257
12-04-2021,Chhattisgarh,4462366,471575,3723,4033441,428925,1939150,2093894,397,40711,4421655,,503,334763,2233978,1464352,4033441
13-04-2021,Chhattisgarh,4559739,446050,3550,4121532,438207,1984387,2136735,410,41359,4518380,,519,335796,2298381,1487008,4121532
14-04-2021,Chhattisgarh,4634362,433220,3431,4186570,447792,2018098,2168049,423,42770,4591592,,526,336585,2346099,1503539,4186570
15-04-2021,Chhattisgarh,4680227,407127,3219,4223870,456357,2038086,2185360,424,44276,4635951,,526,337421,2373187,1512914,4223870
16-04-2021,Chhattisgarh,4749614,420081,3343,4280059,469555,2068132,2211498,429,45939,4703675,,532,338400,2413893,1527420,4280059
17-04-2021,Chhattisgarh,4870174,425810,3442,4376707,493467,2118121,2258142,444,49014,4821160,,533,339881,2484044,1552436,4376707
18-04-2021,Chhattisgarh,4956412,446210,3559,4448418,507994,2154467,2293502,449,51883,4904529,,533,340820,2535913,1571340,4448418
19-04-2021,Chhattisgarh,5043193,455020,3642,4516858,526335,2189661,2326738,459,56887,4986306,,534,341943,2584937,1589634,4516858
20-04-2021,Chhattisgarh,5102706,451500,3611,4561812,540894,2212981,2348364,467,62145,5040561,,540,342942,2616865,1601660,4561812
21-04-2021,Chhattisgarh,5146543,450845,3566,4594052,552491,2229714,2363866,472,66233,5080310,,541,343632,2639930,1610145,4594052
22-04-2021,Chhattisgarh,5212126,451621,3625,4642296,569830,2254515,2387299,482,70829,5141297,,541,344613,2674245,1623092,4642296
23-04-2021,Chhattisgarh,5272734,453245,3634,4686119,586615,2276833,2408793,493,74984,5197750,,541,345839,2705069,1634863,4686119
24-04-2021,Chhattisgarh,5324210,404600,3361,4721290,602920,2294723,2426072,495,78238,5245972,,541,346760,2729964,1644217,4721290
25-04-2021,Chhattisgarh,5362347,374025,3103,4746201,616146,2307527,2438172,502,80052,5282295,,541,347460,2747183,1651208,4746201
26-04-2021,Chhattisgarh,5406298,412765,3332,4772454,633844,2321426,2450519,509,83078,5323220,,543,348688,2764990,1658421,4772454
27-04-2021,Chhattisgarh,5438541,414000,3367,4791314,647227,2331290,2459515,509,85056,5353485,,543,434095,2693217,1663648,4791314
28-04-2021,Chhattisgarh,5469617,396680,3221,4807697,661920,2340040,2467147,510,87930,5381687,,544,435273,2703805,1668261,4807697
29-04-2021,Chhattisgarh,5507510,429550,3432,4823914,683596,2348737,2474666,511,92561,5414949,,544,436628,2714083,1672960,4823914
30-04-2021,Chhattisgarh,5570909,516285,3982,4853003,717906,2364329,2488159,515,98009,5472900,,545,438686,2732660,1681408,4853003
01-05-2021,Chhattisgarh,5620382,514315,3905,4876021,744361,2376648,2498856,517,102959,5517423,,545,441793,2746333,1687645,4876021
02-05-2021,Chhattisgarh,5646987,459480,3551,4887659,759328,2382972,2504170,517,105360,5541627,,545,440332,2756276,1690820,4887659
03-05-2021,Chhattisgarh,5684458,462550,3612,4902668,781790,2391084,2511065,519,109412,5575046,,545,441974,2765470,1694992,4902668
04-05-2021,Chhattisgarh,5715512,457855,3603,4914311,801201,2397373,2516413,525,113467,5602045,,547,443559,2772516,1698001,4914311
05-05-2021,Chhattisgarh,5746229,460100,3603,4925570,820659,2403542,2521503,525,117486,5628743,,547,445061,2779335,1700937,4925570
06-05-2021,Chhattisgarh,5786848,491430,3861,4939907,846941,2411185,2528192,530,122577,5664271,,548,446544,2788142,1704983,4939907
07-05-2021,Chhattisgarh,5815669,478795,3725,4950080,865589,2416824,2532725,531,126630,5689039,,548,447894,2794432,1707515,4950080
08-05-2021,Chhattisgarh,5842656,479610,3739,4958357,884299,2421294,2536529,534,130550,5712106,,549,448959,2799431,1709728,4958357
09-05-2021,Chhattisgarh,5857150,424005,3372,4963503,893647,2423982,2538986,535,133343,5723807,,549,449461,2802868,1710934,4963503
10-05-2021,Chhattisgarh,5906806,452075,3590,4978422,928384,2431782,2546103,537,137165,5769641,,550,450667,2812710,1714790,4978422
11-05-2021,Chhattisgarh,5956903,414605,3364,4993821,963082,2439667,2553616,538,140748,5816155,,550,451783,2823077,1718693,4993821
12-05-2021,Chhattisgarh,5996204,418180,3397,5010466,985738,2448458,2561466,542,145405,5850799,,550,453153,2833923,1723115,5010466
13-05-2021,Chhattisgarh,6046459,412110,3333,5028824,1017635,2458002,2570270,552,150202,5896257,,550,454477,2846278,1727786,5028824
14-05-2021,Chhattisgarh,6095570,410366,3302,5044873,1050697,2466024,2578295,554,153806,5941764,,550,455300,2857447,1731827,5044873
15-05-2021,Chhattisgarh,6138265,463120,3563,5058803,1079462,2473087,2585157,559,158098,5980167,,551,456050,2867587,1734851,5058803
16-05-2021,Chhattisgarh,6142785,420624,3033,5062151,1080634,2474723,2586869,559,159995,5982790,,552,456305,2870101,1735428,5062151
17-05-2021,Chhattisgarh,6149696,463175,3222,5067225,1082471,2477188,2589477,560,162783,5986913,,553,456636,2873970,1736297,5067225
18-05-2021,Chhattisgarh,6155825,443538,3054,5072140,1083685,2479635,2591943,562,165158,5990667,,553,457008,2877695,1737112,5072140
19-05-2021,Chhattisgarh,6162226,433075,2851,5077038,1085188,2482105,2594371,562,167555,5994671,,554,457376,2881374,1737962,5077038
20-05-2021,Chhattisgarh,6169020,430116,2937,5081726,1087294,2484412,2596752,562,169719,5999301,,554,457776,2884773,1738849,5081726
21-05-2021,Chhattisgarh,6175778,412268,2729,5086685,1089093,2486956,2599165,564,171751,6004027,0,554,458330,2888281,1739743,5086685
22-05-2021,Chhattisgarh,6183624,470051,3025,5092839,1090785,2490003,2602271,565,173918,6009706,0,555,458922,2892909,1740673,5092839
23-05-2021,Chhattisgarh,6188816,453244,2977,5097092,1091724,2492070,2604457,565,175407,6013409,0,555,459420,2895979,1741357,5097092
24-05-2021,Chhattisgarh,6195690,412422,2579,5102121,1093569,2494604,2606951,566,177644,6018046,0,557,459927,2899692,1742165,5102121
25-05-2021,Chhattisgarh,6201165,396845,2477,5105905,1095260,2496435,2608903,567,179938,6021227,0,559,460532,2902356,1742679,5105905
26-05-2021,Chhattisgarh,6207632,416251,2508,5110865,1096767,2498921,2611377,567,181885,6025747,0,560,461087,2905958,1743479,5110865
27-05-2021,Chhattisgarh,6211851,363054,2153,5113867,1097984,2500358,2612941,568,183321,6028530,0,562,461634,2907983,1743908,5113867
28-05-2021,Chhattisgarh,6221398,412550,2216,5121403,1099995,2504026,2616807,570,185599,6035799,0,562,462207,2913472,1745381,5121403
29-05-2021,Chhattisgarh,6229290,351338,1944,5127168,1102122,2506872,2619725,571,187725,6041565,0,562,462677,2917704,1746443,5127168
30-05-2021,Chhattisgarh,6233466,328466,1719,5130182,1103284,2508331,2621280,571,189047,6044419,0,563,462917,2919875,1747046,5130182
31-05-2021,Chhattisgarh,6240528,337893,1815,5134658,1105870,2510498,2623589,571,191336,6049192,0,564,463343,2923024,1747945,5134658
01-06-2021,Chhattisgarh,6252505,292455,1393,5139437,1113068,2512844,2626022,571,195719,6056786,0,564,463895,2926331,1748862,5139437
02-06-2021,Chhattisgarh,6260124,299124,1487,5143077,1117047,2514610,2627896,571,198391,6061733,0,564,464246,2928901,1749576,5143077
03-06-2021,Chhattisgarh,6267748,295299,1522,5146027,1121721,2516070,2629385,572,201339,6066409,0,564,464738,2930885,1750049,5146027
04-06-2021,Chhattisgarh,6274404,278190,1448,5148601,1125803,2517333,2630693,575,203908,6070496,0,564,465122,2932593,1750527,5148601
05-06-2021,Chhattisgarh,6282084,287785,1481,5151405,1130679,2518763,2632067,575,206352,6075732,0,564,465488,2934517,1751039,5151405
06-06-2021,Chhattisgarh,6285625,262645,1355,5152970,1132655,2519562,2632832,576,207896,6077729,0,564,465688,2935581,1751340,5152970
07-06-2021,Chhattisgarh,6290982,266426,1417,5155182,1135800,2520678,2633928,576,210344,6080638,0,564,465986,2937058,1751777,5155182
08-06-2021,Chhattisgarh,6296915,250109,1323,5157533,1139382,2521811,2635146,576,212820,6084095,0,564,466402,2938537,1752232,5157533
09-06-2021,Chhattisgarh,6304358,258376,1353,5160281,1144077,2523204,2636501,576,215511,6088847,0,564,466879,2940285,1752754,5160281
10-06-2021,Chhattisgarh,6311317,266438,1365,5162838,1148479,2524464,2637798,576,218061,6093256,0,564,467230,2941979,1753265,5162838
11-06-2021,Chhattisgarh,6318147,250632,1333,5165344,1152803,2525722,2639046,576,220560,6097587,0,564,467668,2943572,1753739,5165344
12-06-2021,Chhattisgarh,6325547,249644,1336,5168451,1157096,2527237,2640636,578,223098,6102449,0,564,468036,2945652,1754398,5168451
13-06-2021,Chhattisgarh,6330309,233660,1239,5170438,1159871,2528194,2641666,578,224870,6105439,0,564,468245,2946972,1754857,5170438
14-06-2021,Chhattisgarh,6337979,254933,1392,5173815,1164164,2529678,2643559,578,227050,6110929,0,564,468715,2948993,1755743,5173815
15-06-2021,Chhattisgarh,6344469,250004,1360,5176603,1167866,2530998,2645027,578,229093,6115376,0,564,469168,2950773,1756298,5176603
16-06-2021,Chhattisgarh,6350848,219355,1244,5179502,1171346,2532383,2646541,578,230609,6120239,0,564,469536,2952596,1757005,5179502
17-06-2021,Chhattisgarh,6357584,251946,1252,5182271,1175313,2533715,2647974,582,232094,6125490,0,564,469943,2954373,1757590,5182271
18-06-2021,Chhattisgarh,6365119,262027,1328,5185507,1179612,2535282,2649643,582,233692,6131427,0,564,470308,2956428,1758406,5185507
19-06-2021,Chhattisgarh,6375229,253583,1358,5189635,1185594,2537196,2651857,582,235332,6139897,0,564,470733,2959114,1759421,5189635
20-06-2021,Chhattisgarh,6380490,248472,1275,5192061,1188429,2538327,2653152,582,236184,6144306,0,564,471006,2960611,1760077,5192061
21-06-2021,Chhattisgarh,6480379,1095142,3026,5278123,1202256,2582034,2695499,590,251667,6228633,79,564,549422,2966155,1762091,5278123
22-06-2021,Chhattisgarh,6605593,1149374,3337,5386159,1219434,2637386,2748170,603,270280,6335234,79,564,646328,2974268,1765039,5386159
23-06-2021,Chhattisgarh,6783572,1587871,4060,5541241,1242331,2715175,2825445,621,286777,6496716,79,565,783283,2987401,1769983,5541241
24-06-2021,Chhattisgarh,7020698,2040667,4268,5739810,1280888,2815059,2924107,644,308524,6712049,125,567,953794,3008136,1777246,5739810
25-06-2021,Chhattisgarh,7245933,2891967,4466,5918014,1327919,3590287,3654886,760,338849,6906959,125,568,1468832,3527191,2249910,5918014
26-06-2021,Chhattisgarh,7602182,4229769,4580,6211885,1390297,3774382,3827003,797,421246,7180769,167,573,1736504,3590861,2274817,6211885
27-06-2021,Chhattisgarh,7821930,3238024,4357,6380368,1441562,3886179,3934926,825,467148,7354615,167,575,1890973,3638360,2292597,6380368
28-06-2021,Chhattisgarh,8104281,3754874,4495,6602957,1501324,4030818,4072602,861,539894,7564211,176,580,2094780,3694435,2315066,6602957
29-06-2021,Chhattisgarh,8313712,3433663,4101,6766414,1547298,4139001,4173834,877,603408,7710093,211,581,2245033,3737527,2331152,6766414
30-06-2021,Chhattisgarh,8453345,3169032,3679,6879610,1573735,4209902,4242537,906,668560,7784554,231,585,2347040,3765346,2340959,6879610
01-07-2021,Chhattisgarh,8588153,2319622,3266,6996558,1591595,4277074,4310150,929,763749,7824170,234,589,2451963,3788154,2348036,6996558
02-07-2021,Chhattisgarh,8680874,2302124,2782,7076496,1604378,4323788,4356138,948,829551,7851081,242,589,2523185,3804733,2352956,7076496
03-07-2021,Chhattisgarh,8823500,2481157,3134,7167424,1656076,4395919,4426618,963,875053,7948204,243,591,2605131,3850492,2367877,7167424
04-07-2021,Chhattisgarh,8904745,2320241,2437,7217817,1686928,4436547,4467227,971,890214,8014288,243,594,2650400,3877642,2376703,7217817
05-07-2021,Chhattisgarh,9001750,2437616,2611,7279827,1721923,4485705,4515060,985,909260,8092239,251,594,2706490,3908541,2386719,7279827
06-07-2021,Chhattisgarh,9044519,1909123,1984,7307678,1736841,4507844,4535688,987,918593,8125447,479,610,2732233,3921368,2390918,7307678
