Updated On,State,TotalDosesAdministered,TotalSessionsConducted,TotalSites ,FirstDoseAdministered,SecondDoseAdministered,Male,Female,Transgender,Covaxin,CoviShield,SputnikV,AEFI,18_45_years,45_60_years,60_+_years,Total_Individuals_Vaccinated
16-03-2021,Delhi,682847,61450,520,539287,143560,370906,168264,117,137588,545259,,604,244554,211503,83130,539287
17-03-2021,Delhi,884805,47950,387,731870,152935,473623,258086,161,184514,700291,,616,246868,236904,247984,731870
18-03-2021,Delhi,925610,64550,550,758842,166768,488818,269860,164,195177,730433,,617,249686,242209,266829,758842
19-03-2021,Delhi,954512,48800,390,776830,177682,498736,277926,168,202405,752107,,619,251622,246205,278885,776830
20-03-2021,Delhi,1002671,64800,548,810104,192567,516701,293229,174,215262,787409,,622,255046,253617,301322,810104
21-03-2021,Delhi,1004072,900,8,811261,192811,517351,293736,174,215631,788441,,624,255275,254002,301865,811261
22-03-2021,Delhi,1046767,71300,591,839942,206825,533079,306685,178,227593,819174,,632,257457,259762,322600,839942
23-03-2021,Delhi,1090763,80200,669,871370,219393,550333,320853,184,240728,850035,,639,260931,267059,343248,871370
24-03-2021,Delhi,1115802,56425,429,889115,226687,560185,328745,185,247730,868072,,648,263219,270951,354812,889115
25-03-2021,Delhi,1158650,84625,700,923806,234844,579493,344123,190,261334,897316,,650,266322,278121,379227,923806
26-03-2021,Delhi,1180586,57955,433,941076,239510,589085,351798,193,267273,913313,,653,268796,281983,390159,941076
27-03-2021,Delhi,1222108,87250,721,977993,244115,608614,369184,195,280988,941120,,660,272127,290857,414867,977993
28-03-2021,Delhi,1222713,9400,91,978569,244144,608920,369454,195,281159,941554,,660,272177,291017,415233,978569
29-03-2021,Delhi,1222719,12400,112,978572,244147,608913,369464,195,281150,941569,,660,272170,291019,415241,978572
30-03-2021,Delhi,1265239,89375,727,1013442,251797,627800,385438,204,295739,969500,,661,274791,298838,439669,1013442
31-03-2021,Delhi,1294057,61050,445,1034327,259730,639330,394788,209,304874,989183,,663,277349,303641,453187,1034327
01-04-2021,Delhi,1355145,93500,745,1087850,267295,667341,420294,215,325561,1029584,,675,279422,336530,471743,1087850
02-04-2021,Delhi,1427069,84600,676,1152888,274181,702254,450407,227,351251,1075818,,685,282359,379009,491359,1152888
03-04-2021,Delhi,1493167,95600,743,1211419,281748,734068,477117,234,373679,1119488,,687,284791,417320,509140,1211419
04-04-2021,Delhi,1578252,92900,735,1290748,287504,777740,512765,243,404762,1173490,,696,286470,472313,531797,1290748
05-04-2021,Delhi,1649227,97350,787,1352825,296402,811003,541572,250,429497,1219730,,703,286882,512970,552804,1352825
06-04-2021,Delhi,1698781,101850,797,1396046,302735,833942,561844,260,447796,1250985,,707,287187,541742,566947,1396046
07-04-2021,Delhi,1784983,66300,480,1469113,315870,873038,595813,262,477505,1307478,,716,287834,590533,590572,1469113
08-04-2021,Delhi,1897519,102100,809,1565572,331947,923456,641838,278,515071,1382448,,724,288370,653853,623173,1565572
09-04-2021,Delhi,1956686,68250,483,1613146,343540,948404,664454,288,532226,1424460,,731,289149,686491,637324,1613146
10-04-2021,Delhi,2062691,105320,803,1705350,357341,995965,709088,297,570732,1491959,,740,290244,750137,664785,1705350
11-04-2021,Delhi,2145719,100310,785,1780609,365110,1037794,742505,310,602240,1543479,,751,290843,804360,685221,1780609
12-04-2021,Delhi,2235902,105250,835,1855493,380409,1079935,775235,323,635229,1600673,,758,292180,855483,707642,1855493
13-04-2021,Delhi,2304883,105650,835,1912002,392881,1115142,796535,325,661547,1643336,,762,293884,894496,723433,1912002
14-04-2021,Delhi,2376987,104650,827,1971274,405713,1149522,821419,333,688050,1688937,,766,295034,935490,740560,1971274
15-04-2021,Delhi,2454871,108050,836,2031982,422889,1185074,846567,341,716471,1738400,,773,297185,976688,757922,2031982
16-04-2021,Delhi,2504071,72850,516,2065695,438376,1205218,860130,347,730737,1773334,,774,299301,999917,766289,2065695
17-04-2021,Delhi,2572685,105020,803,2121099,451586,1239449,881283,367,756067,1816618,,775,301395,1039772,779738,2121099
18-04-2021,Delhi,2621277,98950,787,2162307,458970,1264802,897129,376,774240,1847037,,780,302210,1070170,789733,2162307
19-04-2021,Delhi,2682092,103300,827,2202752,479340,1289105,913261,386,795593,1886499,,788,304718,1096491,801347,2202752
20-04-2021,Delhi,2732507,103450,831,2238271,494236,1310586,927296,389,813979,1918528,,788,306651,1121279,810146,2238271
21-04-2021,Delhi,2787116,100950,802,2277803,509313,1332312,945097,394,832393,1954723,,789,307801,1149491,820315,2277803
22-04-2021,Delhi,2855657,104550,823,2325997,529660,1358333,967263,401,857044,1998613,,792,309990,1183104,832700,2325997
23-04-2021,Delhi,2891857,71000,529,2347381,544476,1370063,976915,403,866767,2025090,,793,311497,1197830,837853,2347381
24-04-2021,Delhi,2962231,99450,792,2395935,566296,1396008,999520,407,892412,2069819,,794,313572,1232683,849474,2395935
25-04-2021,Delhi,3003477,95000,757,2425352,578125,1411612,1013331,409,904993,2098484,,795,314730,1256034,854384,2425352
26-04-2021,Delhi,3061567,99400,805,2461970,599597,1431247,1030308,415,924779,2136788,,800,317012,1281151,863593,2461970
27-04-2021,Delhi,3114832,98800,799,2495676,619156,1449537,1045720,419,943088,2171744,,806,393341,1229853,872266,2495676
28-04-2021,Delhi,3147893,67550,501,2512508,635385,1458364,1053721,423,951007,2196886,,806,394993,1240384,876918,2512508
29-04-2021,Delhi,3224828,97850,796,2558135,666693,1482632,1075072,431,978857,2245971,,809,399636,1269711,888629,2558135
30-04-2021,Delhi,3271950,68640,507,2581651,690299,1495036,1086175,440,992050,2279900,,809,402529,1284424,894533,2581651
01-05-2021,Delhi,3323249,89110,685,2611942,711307,1511816,1099682,444,1014760,2308489,,809,408335,1302811,900631,2611942
02-05-2021,Delhi,3324902,15500,122,2613227,711675,1512591,1100192,444,1015048,2309854,,809,408706,1303758,900669,2613227
03-05-2021,Delhi,3415728,122850,900,2676373,739355,1551202,1124715,456,1054775,2360953,,810,450157,1319948,906172,2676373
04-05-2021,Delhi,3507635,121000,882,2742953,764682,1591565,1150913,475,1093302,2414333,,817,495662,1335733,911451,2742953
05-05-2021,Delhi,3576091,94420,599,2800013,776078,1626372,1173158,483,1117442,2458649,,831,545220,1341313,913373,2800013
06-05-2021,Delhi,3693814,126950,922,2883317,810497,1676526,1206289,502,1165057,2528757,,840,604542,1359039,919621,2883317
07-05-2021,Delhi,3774068,102390,665,2951479,822589,1717488,1233474,517,1193011,2581057,,855,664812,1365071,921479,2951479
08-05-2021,Delhi,3905912,138932,974,3044458,861454,1771228,1272699,531,1244664,2661248,,865,729768,1385727,928827,3044458
09-05-2021,Delhi,3907469,8088,71,3045394,862075,1771717,1273146,531,1244756,2662713,,865,730529,1385874,928855,3045394
10-05-2021,Delhi,4051457,144330,979,3142198,909259,1827189,1314458,551,1299416,2752041,,872,799328,1406277,936280,3142198
11-05-2021,Delhi,4183896,130901,946,3229399,954497,1876398,1352431,570,1346627,2837269,,873,858818,1426444,943661,3229399
12-05-2021,Delhi,4259338,91730,618,3292311,967027,1912592,1379139,580,1363489,2895849,,880,910516,1434818,946396,3292311
13-05-2021,Delhi,4385905,125820,905,3378261,1007644,1960353,1417310,598,1405495,2980410,,888,966037,1456803,954671,3378261
14-05-2021,Delhi,4390592,12960,107,3381649,1008943,1962290,1418759,600,1406138,2984454,,888,969362,1456863,954664,3381649
15-05-2021,Delhi,4511407,126453,936,3464560,1046847,2008240,1455692,628,1441744,3069663,,894,1024902,1476780,961929,3464560
16-05-2021,Delhi,4603220,148063,859,3544850,1058370,2053531,1490666,653,1461962,3141258,,896,1088424,1489088,966287,3544850
17-05-2021,Delhi,4717683,189776,1043,3639716,1077967,2107356,1531683,677,1486103,3231580,,900,1158189,1507717,972642,3639716
18-05-2021,Delhi,4824666,179650,992,3729586,1095080,2158874,1570007,705,1507234,3317432,,910,1222895,1526333,979030,3729586
19-05-2021,Delhi,4893993,132858,701,3791772,1102221,2195074,1595984,714,1514976,3379017,,914,1274621,1534211,981528,3791772
20-05-2021,Delhi,4972927,156873,900,3849484,1123443,2227935,1620816,733,1537051,3435876,,913,1313080,1548483,986355,3849484
21-05-2021,Delhi,5023829,113147,598,3891569,1132260,2251807,1639015,747,1547651,3476178,0,927,1343678,1557148,989101,3891569
22-05-2021,Delhi,5089359,140542,840,3937525,1151834,2277217,1659551,757,1568945,3520414,0,928,1370640,1571167,993986,3937525
23-05-2021,Delhi,5094051,23944,164,3941970,1152081,2279825,1661387,758,1569666,3524385,0,928,1374914,1571281,994041,3941970
24-05-2021,Delhi,5149101,129991,785,3982667,1166434,2302607,1679293,767,1583569,3565532,0,933,1395128,1586405,999292,3982667
25-05-2021,Delhi,5193420,129697,790,4016461,1176959,2322448,1693241,772,1593299,3600121,0,934,1413872,1597571,1003081,4016461
26-05-2021,Delhi,5227641,123383,723,4047233,1180408,2341196,1705259,778,1598134,3629507,0,935,1434073,1605436,1005697,4047233
27-05-2021,Delhi,5267046,133842,755,4081178,1185868,2362008,1718387,783,1602551,3664495,0,936,1455493,1614662,1008863,4081178
28-05-2021,Delhi,5298144,114826,586,4109416,1188728,2379448,1729173,795,1606098,3692046,0,937,1474981,1621141,1011021,4109416
29-05-2021,Delhi,5352466,157171,813,4148595,1203871,2402674,1745120,801,1622828,3729638,0,939,1499494,1631715,1014931,4148595
30-05-2021,Delhi,5362104,34991,154,4157813,1204291,2408287,1748725,801,1623097,3739007,0,942,1508035,1632202,1015113,4157813
31-05-2021,Delhi,5419341,152151,833,4194986,1224355,2429400,1764775,811,1643548,3775793,0,942,1529064,1644082,1019286,4194986
01-06-2021,Delhi,5469628,144952,811,4228359,1241269,2449433,1778109,817,1662436,3807192,0,943,1551375,1652221,1022128,4228359
02-06-2021,Delhi,5506534,127028,621,4257176,1249358,2467041,1789312,823,1671645,3834889,0,946,1571455,1658707,1024299,4257176
03-06-2021,Delhi,5559386,156640,803,4294738,1264648,2489905,1804000,833,1687996,3871390,0,947,1596795,1667590,1027440,4294738
04-06-2021,Delhi,5599054,137401,604,4329324,1269730,2511391,1817070,863,1693027,3906027,0,948,1621602,1674796,1029861,4329324
05-06-2021,Delhi,5656091,159161,735,4371075,1285016,2536381,1833818,876,1708079,3948012,0,950,1649235,1685161,1033429,4371075
06-06-2021,Delhi,5671497,39643,93,4385618,1285879,2544645,1840095,878,1708860,3962637,0,950,1663098,1685556,1033626,4385618
07-06-2021,Delhi,5737887,164270,832,4419597,1318290,2564846,1853867,884,1739312,3998575,0,952,1682139,1696566,1037423,4419597
08-06-2021,Delhi,5786229,162885,767,4445352,1340877,2580204,1864259,889,1760273,4025956,0,953,1698472,1703352,1039967,4445352
09-06-2021,Delhi,5834482,162314,725,4471099,1363383,2595546,1874656,897,1781555,4052927,0,954,1716404,1708995,1042053,4471099
10-06-2021,Delhi,5916278,226438,1133,4521905,1394373,2625225,1895772,908,1811475,4104803,0,955,1756814,1716199,1045124,4521905
11-06-2021,Delhi,5995748,204285,1005,4583464,1412284,2661754,1920782,928,1828779,4166949,20,957,1807855,1723611,1048092,4583464
12-06-2021,Delhi,6079589,217981,1067,4638935,1440654,2693755,1944242,938,1855584,4223915,90,958,1850268,1732943,1051688,4638935
13-06-2021,Delhi,6094030,69518,167,4650867,1443163,2700427,1949498,942,1857898,4236042,90,958,1860334,1734266,1052196,4650867
14-06-2021,Delhi,6154661,205707,1009,4690576,1464085,2723077,1966552,947,1875843,4278508,310,959,1888074,1742692,1055662,4690576
15-06-2021,Delhi,6208289,196867,977,4719321,1488968,2739668,1978707,946,1898154,4309610,525,959,1906456,1750052,1058602,4719321
16-06-2021,Delhi,6263721,185263,882,4756248,1507473,2761123,1994174,951,1916268,4346834,619,959,1934939,1755972,1061020,4756248
17-06-2021,Delhi,6355530,253924,1245,4818228,1537302,2797649,2019613,966,1943850,4411061,619,959,1987344,1762717,1063775,4818228
18-06-2021,Delhi,6434195,233380,1118,4881510,1552685,2835063,2045461,986,1957666,4475910,619,959,2041022,1769567,1066426,4881510
19-06-2021,Delhi,6522118,241299,1190,4943731,1578387,2870619,2072112,1000,1980433,4540976,709,962,2090228,1779035,1069879,4943731
20-06-2021,Delhi,6533793,69187,122,4953785,1580008,2876076,2076706,1003,1982623,4550461,709,962,2099082,1779844,1070238,4953785
21-06-2021,Delhi,6611234,246389,1167,5013438,1597796,2910220,2102183,1035,1998961,4611564,709,962,2145882,1789183,1073669,5013438
22-06-2021,Delhi,6697233,247154,1154,5080592,1616641,2948457,2131075,1060,2013156,4683293,784,962,2200392,1798223,1077170,5080592
23-06-2021,Delhi,6807716,256799,1062,5179708,1628008,3005265,2173353,1090,2020593,4786314,809,963,2290501,1804616,1079556,5179708
24-06-2021,Delhi,6966205,341882,1293,5318124,1648081,3085257,2231717,1150,2031478,4933853,874,968,2418027,1812408,1082206,5318124
25-06-2021,Delhi,7121582,330425,1174,5456691,1664891,4143528,2976702,1352,2036514,5084071,997,979,3027465,2466724,1627393,5456691
26-06-2021,Delhi,7329652,394933,1322,5629446,1700206,4259981,3068259,1412,2050772,5277540,1340,984,3188414,2500409,1640829,5629446
27-06-2021,Delhi,7339238,55797,91,5636415,1702823,4265052,3072774,1412,2051437,5286072,1729,984,3194685,2502711,1641842,5636415
28-06-2021,Delhi,7543922,373166,1321,5801102,1742820,4380504,3161958,1460,2063858,5477699,2365,990,3342543,2542847,1658532,5801102
29-06-2021,Delhi,7747246,389768,1359,5967019,1780227,4494779,3250964,1503,2073817,5670793,2636,990,3492015,2581040,1674191,5967019
30-06-2021,Delhi,7893534,312098,1152,6088879,1804655,4578179,3313808,1547,2080426,5809112,3996,994,3601407,2607426,1684701,6088879
01-07-2021,Delhi,8051352,361412,1329,6214708,1836644,4666967,3382795,1590,2088363,5958585,4404,997,3714277,2639267,1697808,6214708
02-07-2021,Delhi,8212088,347513,1258,6345189,1866899,4756958,3453451,1679,2094013,6113001,5074,1003,3830197,2671452,1710439,6345189
03-07-2021,Delhi,8373332,324063,1269,6466496,1906836,4846270,3525333,1729,2103455,6263579,6298,1022,3938704,2709946,1724682,6466496
04-07-2021,Delhi,8382839,56779,89,6472151,1910688,4851072,3530036,1731,2104519,6271946,6374,1027,3943752,2712992,1726095,6472151
05-07-2021,Delhi,8463689,207306,844,6523882,1939807,4897042,3564895,1752,2113489,6343181,7019,1027,3991391,2736533,1735765,6523882
06-07-2021,Delhi,8498379,140280,539,6543046,1955333,4916611,3580008,1760,2120436,6370167,7776,1031,4010396,2747659,1740324,6543046
