Updated On,State,TotalDosesAdministered,TotalSessionsConducted,TotalSites ,FirstDoseAdministered,SecondDoseAdministered,Male,Female,Transgender,Covaxin,CoviShield,SputnikV,AEFI,18_45_years,45_60_years,60_+_years,Total_Individuals_Vaccinated
16-03-2021,Goa,78377,17600,59,65739,12638,34486,31252,1,0,78377,,498,15629,16293,33809,65739
17-03-2021,Goa,85431,7700,51,72357,13074,38007,34349,1,0,85431,,498,15754,17396,39198,72357
18-03-2021,Goa,88064,7400,51,74794,13270,39245,35547,2,0,88064,,501,15841,17901,41043,74794
19-03-2021,Goa,91419,7200,49,77616,13803,40635,36979,2,0,91419,,501,16036,18683,42888,77616
20-03-2021,Goa,94735,6900,49,80447,14288,41956,38488,3,0,94735,,501,16187,19516,44735,80447
21-03-2021,Goa,94819,100,1,80522,14297,41993,38526,3,0,94819,,502,16193,19550,44770,80522
22-03-2021,Goa,98125,7400,52,83315,14810,43342,39970,3,0,98125,,502,16365,20211,46730,83315
23-03-2021,Goa,101464,7200,51,86286,15178,44796,41487,3,0,101464,,502,16517,20910,48850,86286
24-03-2021,Goa,104768,6900,49,88974,15794,46162,42809,3,0,104768,,502,16657,21643,50665,88974
25-03-2021,Goa,107821,7300,52,91525,16296,47481,44041,3,0,107821,,507,16818,22277,52421,91525
26-03-2021,Goa,111081,8300,56,94110,16971,48822,45285,3,0,111081,,508,17009,22932,54160,94110
27-03-2021,Goa,113726,6900,49,96611,17115,49949,46659,3,0,113726,,508,17173,23582,55847,96611
28-03-2021,Goa,113726,600,5,96611,17115,49948,46660,3,0,113726,,508,17173,23581,55848,96611
29-03-2021,Goa,114575,4200,39,97343,17232,50330,47010,3,0,114575,,508,17209,23775,56350,97343
30-03-2021,Goa,118688,9450,54,100317,18371,51791,48523,3,0,118688,,513,17310,24416,58582,100317
31-03-2021,Goa,121981,12100,69,102595,19386,52951,49640,4,0,121981,,515,17424,24906,60256,102595
01-04-2021,Goa,125601,9700,64,105426,20175,54497,50925,4,0,125601,,515,17529,26642,61246,105426
02-04-2021,Goa,129693,7500,51,108867,20826,56373,52490,4,0,129693,,515,17653,29060,62145,108867
03-04-2021,Goa,133134,7500,54,111519,21615,57777,53738,4,0,133134,,515,17813,30746,62951,111519
04-04-2021,Goa,135851,7300,47,113879,21972,59025,54850,4,0,135851,,516,17866,32439,63565,113879
05-04-2021,Goa,139746,8700,61,116633,23113,60453,56176,4,0,139746,,517,17871,34105,64648,116633
06-04-2021,Goa,142463,9700,70,118691,23772,61494,57193,4,0,142463,,518,17882,35354,65446,118691
07-04-2021,Goa,149580,10200,69,123996,25584,64278,59714,4,0,149580,,519,17899,38665,67422,123996
08-04-2021,Goa,155376,9400,64,128428,26948,66610,61814,4,0,155376,,520,17915,41483,69020,128428
09-04-2021,Goa,162057,8900,64,133268,28789,69290,63974,4,0,162057,,524,17943,44810,70505,133268
10-04-2021,Goa,171070,8600,57,140385,30685,72757,67624,4,0,171070,,524,17973,49667,72735,140385
11-04-2021,Goa,178329,9600,58,147178,31151,76153,71021,4,0,178329,,525,17993,53940,75235,147178
12-04-2021,Goa,188080,18000,65,154523,33557,79862,74654,7,0,188080,,526,18070,58577,77866,154523
13-04-2021,Goa,192563,8200,56,158206,34357,81735,76464,7,0,192563,,526,18091,60898,79207,158206
14-04-2021,Goa,203125,10500,61,167443,35682,86145,81290,8,0,203125,,526,18123,66473,82837,167443
15-04-2021,Goa,213122,10200,59,173909,39213,89205,84695,9,0,213122,,529,18157,70194,85547,173909
16-04-2021,Goa,224966,8900,59,182574,42392,93412,89150,12,0,224966,,534,18238,75283,89041,182574
17-04-2021,Goa,237156,8800,56,191878,45278,97780,94085,13,0,237156,,534,18297,81039,92530,191878
18-04-2021,Goa,244577,7700,52,198368,46209,100810,97544,14,0,244577,,536,18331,85044,94981,198368
19-04-2021,Goa,253784,8500,59,204861,48923,103836,101010,15,0,253784,,536,18394,88888,97566,204861
20-04-2021,Goa,264363,8500,61,212256,52107,107462,104778,16,0,264363,,536,18490,93292,100461,212256
21-04-2021,Goa,272843,9500,65,218280,54563,110516,107748,16,0,272843,,536,18573,97001,102692,218280
22-04-2021,Goa,281424,10100,66,224561,56863,113504,111041,16,0,281424,,538,18639,100851,105057,224561
23-04-2021,Goa,289688,9200,64,230437,59251,116263,114157,17,0,289688,,541,18836,104536,107051,230437
24-04-2021,Goa,299120,8200,59,237544,61576,119513,118013,18,0,299120,,541,18964,109294,109271,237544
25-04-2021,Goa,304009,4700,43,241453,62556,121382,120053,18,0,304009,,541,19013,111838,110586,241453
26-04-2021,Goa,313009,8100,58,248280,64729,124565,123697,18,0,313009,,542,19147,116061,113055,248280
27-04-2021,Goa,323213,9200,63,256196,67017,128306,127872,18,0,323213,,543,24498,115719,115962,256196
28-04-2021,Goa,331720,9920,68,262802,68918,131482,131302,18,0,331720,,543,24921,119670,118194,262802
29-04-2021,Goa,340659,8920,61,269749,70910,134717,135014,18,0,340659,,545,25352,123938,120451,269749
30-04-2021,Goa,349718,8820,65,277125,72593,138452,138655,18,0,349718,,546,25910,128663,122543,277125
01-05-2021,Goa,355269,7000,48,282005,73264,140915,141071,19,0,355269,,547,26125,132003,123868,282005
02-05-2021,Goa,358280,6100,41,284560,73720,142173,142367,20,0,358280,,548,26172,133683,124699,284560
03-05-2021,Goa,363592,7550,51,288805,74787,144181,144604,20,157,363435,,553,26519,136275,126005,288805
04-05-2021,Goa,368857,7307,50,292908,75949,146277,146611,20,360,368497,,553,26928,138728,127246,292908
05-05-2021,Goa,373997,7520,49,296579,77418,148079,148480,20,579,373418,,553,27340,140815,128418,296579
06-05-2021,Goa,379927,7812,53,300663,79264,150067,150576,20,793,379134,,553,27952,143093,129612,300663
07-05-2021,Goa,386450,7806,51,305206,81244,152622,152563,21,996,385454,,553,29328,145196,130676,305206
08-05-2021,Goa,392342,7802,53,309334,83008,154712,154601,21,1199,391143,,553,30574,147154,131600,309334
09-05-2021,Goa,394413,6000,41,310955,83458,155634,155300,21,1199,393214,,553,30992,147953,132004,310955
10-05-2021,Goa,399718,7708,52,314583,85135,157647,156915,21,1406,398312,,556,32116,149619,132842,314583
11-05-2021,Goa,405500,7522,49,318352,87148,159762,158569,21,1625,403875,,556,33499,151197,133649,318352
12-05-2021,Goa,411191,9424,54,322251,88940,161973,160257,21,1836,409355,,556,35049,152699,134494,322251
13-05-2021,Goa,418484,9302,54,327646,90838,165055,162570,21,2221,416263,,556,37518,154655,135464,327646
14-05-2021,Goa,425521,7806,50,332990,92531,167894,165075,21,2422,423099,,556,39860,156688,136432,332990
15-05-2021,Goa,436458,12108,90,342243,94215,173190,169032,21,2828,433630,,556,46351,158645,137232,342243
16-05-2021,Goa,438881,10050,77,344615,94266,174548,170046,21,2828,436053,,556,48577,158755,137268,344615
17-05-2021,Goa,444923,16600,89,350557,94366,178060,172474,23,3008,441915,,556,53669,159367,137499,350557
18-05-2021,Goa,451943,15853,92,357502,94441,182028,175451,23,3237,448706,,558,59071,160461,137945,357502
19-05-2021,Goa,459632,15503,87,365111,94521,186366,178720,25,3422,456210,,559,64891,161701,138494,365111
20-05-2021,Goa,466522,15419,89,371961,94561,190214,181720,27,3644,462878,,559,70321,162698,138913,371961
21-05-2021,Goa,475384,17907,92,380740,94644,195006,185707,27,3878,471506,0,559,76334,164655,139722,380740
22-05-2021,Goa,483931,18090,96,389263,94668,199545,189691,27,4185,479746,0,562,82325,166453,140456,389263
23-05-2021,Goa,485579,11151,42,390887,94692,200344,190516,27,4185,481394,0,562,83019,167094,140745,390887
24-05-2021,Goa,491326,16251,64,396608,94718,203228,193352,28,4779,486547,0,562,85629,169109,141840,396608
25-05-2021,Goa,497180,17663,72,402427,94753,206354,196044,29,5357,491823,0,562,88550,170967,142879,402427
26-05-2021,Goa,503101,24029,76,408309,94792,209371,198907,31,5547,497554,0,563,90671,173418,144188,408309
27-05-2021,Goa,508928,21064,63,414098,94830,212227,201838,33,5843,503085,0,563,92748,175814,145503,414098
28-05-2021,Goa,514992,22277,71,420107,94885,215175,204899,33,6303,508689,0,563,95119,178217,146737,420107
29-05-2021,Goa,521480,22352,64,426519,94961,218656,207830,33,6629,514851,0,564,98225,180461,147796,426519
30-05-2021,Goa,524372,17862,48,429393,94979,220042,209317,34,6629,517743,0,564,99045,181774,148537,429393
31-05-2021,Goa,528955,22613,59,433855,95100,222586,211234,35,7291,521664,0,564,100973,183436,149407,433855
01-06-2021,Goa,533504,23685,63,438285,95219,225304,212945,36,8029,525475,0,564,103503,184720,150023,438285
02-06-2021,Goa,537792,22070,56,442390,95402,227614,214739,37,8685,529107,0,565,105467,186152,150722,442390
03-06-2021,Goa,543715,39400,97,448111,95604,230718,217354,39,9177,534538,0,567,109214,187469,151378,448111
04-06-2021,Goa,551988,40572,99,456053,95935,234900,221113,40,9573,542415,0,567,115716,188466,151818,456053
05-06-2021,Goa,563779,38764,95,467529,96250,239949,227539,41,9942,553837,0,571,125977,189361,152136,467529
06-06-2021,Goa,570434,33620,82,474147,96287,242518,231588,41,9941,560493,0,571,131977,189789,152325,474147
07-06-2021,Goa,581671,35084,91,485171,96500,248239,236889,43,10208,571463,0,571,141846,190626,152639,485171
08-06-2021,Goa,592178,33713,91,495452,96726,253581,241827,44,10469,581709,0,571,151041,191404,152942,495452
09-06-2021,Goa,600833,31247,94,503890,96943,257801,246045,44,10804,590029,0,573,158488,192126,153208,503890
10-06-2021,Goa,608564,30166,86,511379,97185,261168,250167,44,11064,597500,0,573,164955,192877,153478,511379
11-06-2021,Goa,614418,30407,85,516897,97521,263817,253036,44,11467,602951,0,573,169278,193713,153837,516897
12-06-2021,Goa,621644,30748,84,523796,97848,267169,256581,46,12030,609614,0,574,174782,194734,154210,523796
13-06-2021,Goa,638918,48398,80,541029,97889,275956,265024,49,12030,626888,0,574,191047,195479,154427,541029
14-06-2021,Goa,658193,54319,90,559670,98523,285915,273704,51,12833,645360,0,575,207812,196819,154952,559670
15-06-2021,Goa,676789,62343,90,577925,98864,296382,281489,54,13213,663576,0,575,224258,198212,155359,577925
16-06-2021,Goa,691969,70163,85,592719,99250,304922,287743,54,13885,678084,0,576,237508,199363,155743,592719
17-06-2021,Goa,708794,69132,87,609077,99717,314413,294609,55,14685,694109,0,576,251823,200905,156239,609077
18-06-2021,Goa,726686,72743,92,626378,100308,324041,302279,58,15474,711212,0,576,266838,202605,156817,626378
19-06-2021,Goa,747361,71984,86,646436,100925,335055,311321,60,15908,731453,0,576,284439,204523,157351,646436
20-06-2021,Goa,760206,69330,76,659181,101025,341948,317171,62,15908,744298,0,576,295356,205921,157778,659181
21-06-2021,Goa,776098,72122,85,674546,101552,350662,323810,74,16210,759888,0,576,308191,207761,158455,674546
22-06-2021,Goa,791272,72987,85,688792,102480,358829,329888,75,16527,774745,0,576,319843,209665,159139,688792
23-06-2021,Goa,805001,72666,83,701689,103312,366160,335454,75,16815,788186,0,576,330293,211445,159801,701689
24-06-2021,Goa,818202,74701,86,713714,104488,373424,340215,75,17056,801146,0,577,340055,213114,160391,713714
25-06-2021,Goa,833836,76381,85,728178,105658,436363,397399,74,17479,816357,0,580,374778,239471,219587,728178
26-06-2021,Goa,856142,79103,87,748351,107791,448364,407702,76,17930,838212,0,580,391956,243270,220916,748351
27-06-2021,Goa,871472,70405,74,762729,108743,457116,414280,76,17930,853542,0,580,403808,245823,221841,762729
28-06-2021,Goa,892220,73951,81,781063,111157,468714,423427,79,18115,874105,0,580,418292,250118,223810,781063
29-06-2021,Goa,914013,74756,81,800268,113745,480867,433066,80,18273,895740,0,580,433541,254525,225947,800268
30-06-2021,Goa,934022,78468,84,817485,116537,492310,441627,85,18714,915308,0,581,447388,258764,227870,817485
01-07-2021,Goa,946993,73637,82,827800,119193,500092,446815,86,18835,928158,0,581,455762,261915,229316,827800
02-07-2021,Goa,960730,77461,84,837780,122950,508259,452385,86,19307,941423,0,582,464083,265775,230872,837780
03-07-2021,Goa,980683,80989,81,852875,127808,519764,460831,88,20024,960659,0,582,477015,270865,232803,852875
04-07-2021,Goa,990480,68260,70,859902,130578,525562,464830,88,20024,970456,0,582,482787,273732,233961,859902
05-07-2021,Goa,1006988,77509,82,870453,136535,534998,471898,92,20960,986028,0,582,491564,278754,236670,870453
06-07-2021,Goa,1021435,77611,81,880174,141261,543046,478294,95,21116,1000319,0,582,499060,283213,239162,880174
