Updated On,State,TotalDosesAdministered,TotalSessionsConducted,TotalSites ,FirstDoseAdministered,SecondDoseAdministered,Male,Female,Transgender,Covaxin,CoviShield,SputnikV,AEFI,18_45_years,45_60_years,60_+_years,Total_Individuals_Vaccinated
16-03-2021,Gujarat,2772614,429226,2997,2208185,564429,1176802,1031250,133,409421,2363193,,830,588839,572477,1044914,2208185
17-03-2021,Gujarat,2923717,146585,972,2349458,574259,1250281,1099019,158,413862,2509855,,834,592114,598883,1156489,2349458
18-03-2021,Gujarat,3112038,534218,3853,2521859,590179,1336946,1184732,181,426330,2685708,,836,599698,637757,1282421,2521859
19-03-2021,Gujarat,3309060,611443,4358,2705730,603330,1429011,1276525,194,439823,2869237,,841,606677,681121,1415928,2705730
20-03-2021,Gujarat,3546628,708147,5021,2933180,613448,1541678,1391288,214,460253,3086375,,844,614521,739293,1577346,2933180
21-03-2021,Gujarat,3756195,559156,4099,3140047,616148,1643518,1496292,237,489360,3266835,,844,617789,791019,1729205,3140047
22-03-2021,Gujarat,3931630,715281,5283,3308984,622646,1726847,1581878,259,513578,3418052,,848,623052,833937,1849951,3308984
23-03-2021,Gujarat,4201102,721968,5376,3571094,630008,1853941,1716869,284,562336,3638766,,849,629971,901751,2037305,3571094
24-03-2021,Gujarat,4381443,599444,4567,3746626,634817,1939996,1806318,312,597932,3783511,,851,635537,952908,2156103,3746626
25-03-2021,Gujarat,4618906,806230,5670,3979710,639196,2055993,1923375,342,632475,3986431,,857,644996,1026343,2306284,3979710
26-03-2021,Gujarat,4861329,822146,5731,4217590,643739,2175802,2041414,374,663383,4197946,,864,665458,1110770,2439247,4217590
27-03-2021,Gujarat,5116383,773331,5312,4469272,647111,2304300,2164568,404,670729,4445654,,868,688839,1207160,2571137,4469272
28-03-2021,Gujarat,5207119,572833,4007,4559341,647778,2352888,2206042,411,671258,4535861,,868,694774,1244234,2618189,4559341
29-03-2021,Gujarat,5225227,395284,2565,4576803,648424,2362943,2213448,412,671316,4553911,,869,696253,1254215,2624191,4576803
30-03-2021,Gujarat,5438943,827534,5764,4769080,669863,2461576,2307069,435,672678,4766265,,873,713631,1331156,2722131,4769080
31-03-2021,Gujarat,5655568,865660,5890,4961044,694524,2564803,2395772,469,673898,4981670,,874,737467,1412337,2809067,4961044
01-04-2021,Gujarat,5937684,978670,6771,5220204,717480,2705708,2514001,495,674797,5262887,,877,765906,1586012,2866097,5220204
02-04-2021,Gujarat,6454155,907774,6286,5696407,757748,2966470,2729381,556,676358,5777797,,884,824445,1910442,2959275,5696407
03-04-2021,Gujarat,6838585,820260,5679,6049037,789548,3165438,2883005,594,686336,6152249,,890,882687,2139834,3024227,6049037
04-04-2021,Gujarat,7313218,810718,5404,6481838,831380,3404050,3077142,646,743611,6569607,,901,925854,2440656,3112985,6481838
05-04-2021,Gujarat,7584968,940175,6357,6722336,862632,3532159,3189502,675,783722,6801246,,904,927096,2618055,3174831,6722336
06-04-2021,Gujarat,7787907,834618,5701,6904732,883175,3629219,3274818,695,819115,6968792,,907,927474,2757314,3217589,6904732
07-04-2021,Gujarat,8108812,654905,4313,7190429,918383,3780179,3409521,729,895975,7212837,,909,927902,2974598,3285575,7190429
08-04-2021,Gujarat,8473351,1012993,6752,7499654,973697,3941673,3557205,776,930838,7542513,,911,928251,3209082,3359962,7499654
09-04-2021,Gujarat,8772856,1057645,7110,7748080,1024776,4074678,3672597,805,949566,7823290,,914,933761,3393896,3418066,7748080
10-04-2021,Gujarat,9055878,935843,6038,7982633,1073245,4201334,3780467,832,961536,8094342,,916,942210,3568325,3469737,7982633
11-04-2021,Gujarat,9258859,972497,6260,8155231,1103628,4294087,3860292,852,972503,8286356,,921,947822,3694865,3510180,8155231
12-04-2021,Gujarat,9497513,1023198,6969,8342548,1154965,4395081,3946587,880,981293,8516220,,922,957944,3828510,3553723,8342548
13-04-2021,Gujarat,9703358,932485,6404,8501205,1202153,4481244,4019052,909,984510,8718848,,925,967663,3939193,3591977,8501205
14-04-2021,Gujarat,9866787,989159,6837,8622576,1244211,4547426,4074221,929,987663,8879124,,926,975317,4023468,3621413,8622576
15-04-2021,Gujarat,10026689,978239,6765,8728318,1298371,4606765,4120607,946,992251,9034438,,926,985557,4090512,3649864,8728318
16-04-2021,Gujarat,10165300,1014593,6967,8814264,1351036,4655481,4157816,967,998071,9167229,,931,996268,4142407,3673196,8814264
17-04-2021,Gujarat,10336808,940003,6505,8921355,1415453,4715787,4204581,987,1006242,9330566,,932,1008946,4209799,3700218,8921355
18-04-2021,Gujarat,10450564,949451,6668,8991639,1458925,4754203,4236432,1004,1010942,9439622,,932,1013643,4256810,3718793,8991639
19-04-2021,Gujarat,10620128,1029983,7218,9083040,1537088,4804830,4277189,1021,1020152,9599976,,936,1022465,4311770,3746410,9083040
20-04-2021,Gujarat,10806479,966204,6823,9181042,1625437,4859276,4320718,1048,1035224,9771255,,937,1031492,4370676,3776475,9181042
21-04-2021,Gujarat,10937835,964950,6858,9250895,1686940,4897672,4352167,1056,1043714,9894121,,938,1037748,4412794,3797953,9250895
22-04-2021,Gujarat,11098076,1000556,6996,9328416,1769660,4939698,4387652,1066,1063478,10034598,,940,1045379,4457709,3822925,9328416
23-04-2021,Gujarat,11266124,963281,6677,9412213,1853911,4986233,4424885,1095,1085356,10180768,,940,1055109,4507340,3847361,9412213
24-04-2021,Gujarat,11436249,796685,5524,9495699,1940550,5032232,4462353,1114,1104672,10331577,,940,1064695,4558264,3870338,9495699
25-04-2021,Gujarat,11537861,599070,3852,9549793,1988068,5061199,4487467,1127,1117611,10420250,,942,1069110,4591959,3886321,9549793
26-04-2021,Gujarat,11720832,918371,6488,9634190,2086642,5106604,4526440,1146,1133157,10587675,,944,1077993,4641823,3911952,9634190
27-04-2021,Gujarat,11901253,891606,6256,9718868,2182385,5152760,4564947,1161,1147759,10753494,,945,1353261,4426668,3936509,9718868
28-04-2021,Gujarat,12053881,677990,4524,9787160,2266721,5189736,4596254,1170,1160903,10892978,,946,1363066,4465868,3955794,9787160
29-04-2021,Gujarat,12251389,893310,6316,9873924,2377465,5235908,4636831,1185,1177260,11074129,,947,1374043,4517596,3980107,9873924
30-04-2021,Gujarat,12457754,944697,6653,9965407,2492347,5286177,4678032,1198,1196985,11260769,,948,1388671,4570689,4003854,9965407
01-05-2021,Gujarat,12679389,1025900,7006,10092582,2586807,5360591,4730776,1215,1216289,11463100,,949,1450903,4616852,4022630,10092582
02-05-2021,Gujarat,12803024,784839,5247,10161231,2641793,5400145,4759855,1231,1228523,11574501,,949,1476079,4651128,4031914,10161231
03-05-2021,Gujarat,12966110,892139,6070,10243032,2723078,5445977,4795809,1246,1253962,11712148,,949,1509709,4685898,4045312,10243032
04-05-2021,Gujarat,13094157,882833,5846,10330960,2763197,5497821,4831879,1260,1286410,11807747,,950,1568206,4707870,4052766,10330960
05-05-2021,Gujarat,13267196,742193,5050,10417828,2849368,5546804,4869749,1275,1317572,11949624,,952,1611025,4740644,4064039,10417828
06-05-2021,Gujarat,13473812,957773,6241,10505574,2968238,5594877,4909411,1286,1353073,12120739,,953,1645838,4778970,4078641,10505574
07-05-2021,Gujarat,13680484,931807,5991,10593635,3086849,5642864,4949468,1303,1385646,12294838,,953,1676539,4820383,4094581,10593635
08-05-2021,Gujarat,13881007,935848,5893,10676626,3204381,5687849,4987458,1319,1410541,12470466,,956,1705940,4859292,4109256,10676626
09-05-2021,Gujarat,14036695,770690,4835,10741045,3295650,5723304,5016410,1331,1429197,12607498,,959,1734090,4885465,4119351,10741045
10-05-2021,Gujarat,14301060,861541,5710,10840347,3460713,5776916,5062083,1348,1459681,12841379,,960,1769289,4930642,4138153,10840347
11-05-2021,Gujarat,14610441,928750,6126,10952235,3658206,5837934,5112931,1370,1503298,13107143,,963,1809143,4982121,4158628,10952235
12-05-2021,Gujarat,14767554,682310,4428,11041502,3726052,5886779,5153338,1385,1544826,13222728,,963,1846256,5019269,4173575,11041502
13-05-2021,Gujarat,14975803,699491,4607,11145747,3830056,5943172,5201177,1398,1591042,13384761,,963,1885053,5065749,4192492,11145747
14-05-2021,Gujarat,15019896,210801,1578,11180770,3839126,5963582,5215785,1403,1620083,13399813,,964,1916633,5068203,4193470,11180770
15-05-2021,Gujarat,15055582,212660,1637,11213044,3842538,5982566,5229067,1411,1647234,13408348,,965,1948048,5068749,4193758,11213044
16-05-2021,Gujarat,15085762,178338,1310,11243101,3842661,5999825,5241859,1417,1668359,13417403,,965,1977910,5068906,4193785,11243101
17-05-2021,Gujarat,15086042,193224,1381,11243305,3842737,5999917,5241971,1417,1668343,13417699,,965,1978060,5068942,4193803,11243305
18-05-2021,Gujarat,15086347,198700,1431,11243561,3842786,6000064,5242080,1417,1668327,13418020,,965,1978301,5068954,4193806,11243561
19-05-2021,Gujarat,15087757,136525,1035,11244920,3842837,6001265,5242238,1417,1668322,13419435,,966,1979481,5069103,4193835,11244920
20-05-2021,Gujarat,15178758,324152,2346,11322050,3856708,6043975,5276648,1427,1713265,13465493,,967,2025817,5092590,4201114,11322050
21-05-2021,Gujarat,15283427,347280,2412,11411002,3872425,6092468,5317094,1440,1745516,13537911,0,967,2072654,5125901,4209895,11411002
22-05-2021,Gujarat,15409606,470581,2983,11511484,3898122,6146604,5363419,1461,1782573,13627033,0,969,2119511,5167281,4222126,11511484
23-05-2021,Gujarat,15516777,389433,2576,11596730,3920047,6191809,5403442,1479,1806036,13710741,0,969,2164839,5197733,4231585,11596730
24-05-2021,Gujarat,15704013,440591,2566,11761248,3942765,6281915,5477831,1502,1830304,13873709,0,976,2279412,5236290,4242943,11761248
25-05-2021,Gujarat,15900264,476234,2786,11931536,3968728,6375784,5554222,1530,1859369,14040895,0,977,2394991,5278123,4255805,11931536
26-05-2021,Gujarat,16089270,484391,2891,12096866,3992404,6468044,5627269,1553,1881227,14208043,0,981,2511240,5315825,4267155,12096866
27-05-2021,Gujarat,16288328,349209,1898,12267948,4020380,6563659,5702702,1587,1912467,14375861,0,984,2630408,5355486,4279381,12267948
28-05-2021,Gujarat,16506745,395613,1823,12450336,4056409,6665620,5783096,1620,1947731,14559014,0,989,2749989,5403720,4293917,12450336
29-05-2021,Gujarat,16724256,384261,1813,12634113,4090143,6769916,5862544,1653,1977768,14746488,0,989,2870946,5451607,4308813,12634113
30-05-2021,Gujarat,16910245,362403,1732,12795634,4114611,6859868,5934085,1681,1998001,14912244,0,991,2984899,5487136,4320813,12795634
31-05-2021,Gujarat,17110619,385100,1857,12965663,4144956,6954068,6009885,1710,2027524,15083095,0,994,3102409,5526556,4333882,12965663
01-06-2021,Gujarat,17309564,390080,1849,13131370,4178194,7046593,6083037,1740,2057837,15251727,0,998,3217691,5564339,4346484,13131370
02-06-2021,Gujarat,17486132,384041,1812,13283712,4202420,7131694,6150252,1766,2080011,15406121,0,999,3326465,5597207,4357151,13283712
03-06-2021,Gujarat,17665975,391891,1852,13433285,4232690,7216757,6214740,1788,2105389,15560586,0,1000,3429434,5632286,4368655,13433285
04-06-2021,Gujarat,17936071,512778,2329,13674583,4261488,7358698,6314033,1852,2132268,15803803,0,1002,3625807,5665388,4380386,13674583
05-06-2021,Gujarat,18201215,479610,2224,13915183,4286032,7500857,6412426,1900,2154329,16046886,0,1004,3826189,5695899,4390036,13915183
06-06-2021,Gujarat,18427691,444175,2087,14128072,4299619,7623531,6502596,1945,2181397,16246294,0,1005,4009695,5718114,4397135,14128072
07-06-2021,Gujarat,18686516,490969,2246,14359541,4326975,7755563,6601968,2010,2205473,16481043,0,1007,4200747,5748149,4407463,14359541
08-06-2021,Gujarat,18949901,486743,2272,14587473,4362428,7886709,6698709,2055,2249623,16700278,0,1007,4385499,5780135,4418575,14587473
09-06-2021,Gujarat,19203211,484148,2206,14801548,4401663,8011027,6788413,2108,2308692,16894519,0,1007,4564021,5806678,4427518,14801548
10-06-2021,Gujarat,19478852,486093,2284,15022634,4456218,8139182,6881264,2188,2364338,17114514,0,1009,4745532,5835771,4437903,15022634
11-06-2021,Gujarat,19769106,492859,2308,15262470,4506636,8280351,6979879,2240,2414734,17354372,0,1009,4942019,5867460,4449484,15262470
12-06-2021,Gujarat,20068185,477736,2196,15522137,4546048,8439118,7080715,2304,2440016,17628169,0,1011,5153706,5903268,4461577,15522137
13-06-2021,Gujarat,20303072,419691,1992,15729860,4573212,8562868,7164652,2340,2460501,17842571,0,1011,5328426,5927432,4470341,15729860
14-06-2021,Gujarat,20587151,487611,2244,15979244,4607907,8709335,7267529,2380,2474478,18112673,0,1013,5533914,5958395,4483187,15979244
15-06-2021,Gujarat,20855692,462376,2213,16214004,4641688,8847218,7364359,2427,2487006,18368686,0,1013,5723559,5991202,4495411,16214004
16-06-2021,Gujarat,21112010,452300,2170,16440786,4671224,8980617,7457692,2477,2495920,18616090,0,1015,5911304,6019676,4505908,16440786
17-06-2021,Gujarat,21334287,416388,2042,16632294,4701993,9093371,7536411,2512,2508022,18826265,0,1017,6068279,6044537,4515503,16632294
18-06-2021,Gujarat,21596263,477360,2247,16854511,4741752,9221998,7629940,2573,2516083,19080180,0,1017,6250495,6073186,4526769,16854511
19-06-2021,Gujarat,21903561,566592,2352,17116300,4787261,9374771,7738902,2627,2521478,19382083,0,1017,6466522,6106995,4538625,17116300
20-06-2021,Gujarat,22099535,500558,1966,17278756,4820779,9468219,7807874,2663,2535203,19564332,0,1017,6602142,6126677,4545709,17278756
21-06-2021,Gujarat,22619651,1212745,4268,17730463,4889188,9718877,8008832,2754,2580075,20039576,0,1017,6978741,6182829,4564421,17730463
22-06-2021,Gujarat,23067276,1077401,3841,18105136,4962140,9923919,8178392,2825,2623677,20443599,0,1018,7281077,6236118,4583316,18105136
23-06-2021,Gujarat,23513610,1078637,3677,18475269,5038341,10126574,8345796,2899,2651638,20861972,0,1018,7578829,6289118,4602565,18475269
24-06-2021,Gujarat,23968923,1105067,3710,18826982,5141941,10325430,8498573,2979,2676641,21292282,0,1021,7858001,6342279,4621829,18826982
25-06-2021,Gujarat,24271144,774867,2739,19053252,5217892,13194143,11073520,3481,2701521,21569623,0,1025,9093965,8259600,6917579,19053252
26-06-2021,Gujarat,24657300,964029,3121,19330981,5326319,13409582,11244180,3538,2847731,21809569,0,1031,9355941,8349301,6952058,19330981
27-06-2021,Gujarat,24887523,616705,2143,19500271,5387252,13537898,11346051,3574,2917629,21969894,0,1034,9504925,8407657,6974941,19500271
28-06-2021,Gujarat,25141162,733257,2211,19683467,5457695,13676302,11461259,3601,2978729,22162433,0,1039,9659973,8477346,7003843,19683467
29-06-2021,Gujarat,25408616,734425,2229,19872911,5535705,13821023,11583934,3659,3044974,22363642,0,1041,9817421,8556516,7034679,19872911
30-06-2021,Gujarat,25692042,746252,2310,20070872,5621170,13975657,11712644,3741,3077789,22614253,0,1044,9982630,8641685,7067727,20070872
01-07-2021,Gujarat,25973769,495605,2392,20266271,5707498,14127199,11842772,3798,3086327,22887287,155,1047,10142658,8727800,7103311,20266271
02-07-2021,Gujarat,26219791,398411,2184,20427199,5792592,14259486,11956463,3842,3092723,23126843,225,1050,10275536,8808551,7135704,20427199
03-07-2021,Gujarat,26552791,506819,2329,20653026,5899765,14441073,12107818,3900,3110442,23442013,336,1053,10461866,8915651,7175274,20653026
04-07-2021,Gujarat,26815799,447265,2147,20835546,5980253,14586094,12225766,3939,3139824,23675634,341,1054,10611567,8998480,7205752,20835546
05-07-2021,Gujarat,27118289,493746,2291,21037286,6081003,14748092,12366208,3989,3153557,23964111,621,1056,10774679,9097357,7246253,21037286
06-07-2021,Gujarat,27331752,346485,1828,21181190,6150562,14862377,12465349,4026,3189898,24140851,1003,1061,10894197,9164880,7272675,21181190
