Updated On,State,TotalDosesAdministered,TotalSessionsConducted,TotalSites ,FirstDoseAdministered,SecondDoseAdministered,Male,Female,Transgender,Covaxin,CoviShield,SputnikV,AEFI,18_45_years,45_60_years,60_+_years,Total_Individuals_Vaccinated
16-03-2021,Himachal Pradesh,273299,60690,453,203011,70288,102426,100574,11,0,273299,,504,56838,66517,79591,203011
17-03-2021,Himachal Pradesh,308812,27150,193,236523,72289,120682,115821,20,2,308810,,509,57386,68863,110204,236523
18-03-2021,Himachal Pradesh,337481,60800,515,262915,74566,134225,128667,23,2,337479,,515,57994,70304,134543,262915
19-03-2021,Himachal Pradesh,358451,42500,319,281109,77342,143557,137527,25,2,358449,,518,58328,71867,150840,281109
20-03-2021,Himachal Pradesh,369805,23000,181,290409,79396,148344,142039,26,2,369803,,521,58723,72717,158894,290409
21-03-2021,Himachal Pradesh,371574,11750,86,292027,79547,149138,142862,27,2,371572,,523,58771,72887,160294,292027
22-03-2021,Himachal Pradesh,381047,27350,210,300139,80908,153388,146723,28,2,381045,,524,59108,73564,167391,300139
23-03-2021,Himachal Pradesh,404158,57800,457,321471,82687,164076,157364,31,2,404156,,526,59836,75089,186465,321471
24-03-2021,Himachal Pradesh,416718,30750,236,333002,83716,170230,162739,33,2,416716,,529,60231,75946,196744,333002
25-03-2021,Himachal Pradesh,455004,81900,729,370260,84744,188658,181561,41,2,455002,,536,61031,78068,231074,370260
26-03-2021,Himachal Pradesh,476805,45900,347,390817,85988,199037,191736,44,2,476803,,538,61953,79607,249169,390817
27-03-2021,Himachal Pradesh,496972,43950,361,410497,86475,208804,201644,49,2,496970,,543,62521,80862,267020,410497
28-03-2021,Himachal Pradesh,498085,10450,88,411591,86494,209300,202242,49,2,498083,,543,62556,81252,267689,411591
29-03-2021,Himachal Pradesh,498916,14950,124,412400,86516,209674,202677,49,2,498914,,543,62580,81292,268434,412400
30-03-2021,Himachal Pradesh,527330,72261,573,439684,87646,223247,216384,53,2,527328,,547,63013,83305,293270,439684
31-03-2021,Himachal Pradesh,536465,38550,319,448077,88388,227646,220378,53,2,536463,,547,63295,84292,300393,448077
01-04-2021,Himachal Pradesh,574177,77820,700,484952,89225,244680,240210,62,2,574175,,549,63577,101879,319398,484952
02-04-2021,Himachal Pradesh,594644,28220,239,504793,89851,254201,250525,67,2,594642,,552,63886,113136,327672,504793
03-04-2021,Himachal Pradesh,611300,33900,272,520521,90779,262034,258417,70,2,611298,,554,64126,122874,333422,520521
04-04-2021,Himachal Pradesh,631189,26950,234,539485,91704,271327,268087,71,2,631187,,555,64308,135926,339151,539485
05-04-2021,Himachal Pradesh,661559,61900,491,568597,92962,284671,283855,71,2,661557,,558,64336,154607,349554,568597
06-04-2021,Himachal Pradesh,688362,82450,671,594144,94218,296254,297812,78,2,688360,,559,64339,171340,358366,594144
07-04-2021,Himachal Pradesh,775168,67400,555,677374,97794,334084,343198,92,2,775166,,569,64371,227605,385297,677374
08-04-2021,Himachal Pradesh,841809,95050,799,741610,100199,363032,378478,100,2,841807,,573,64374,272102,405033,741610
09-04-2021,Himachal Pradesh,891279,76900,611,788372,102907,384626,403640,106,2,891277,,579,64492,304879,418899,788372
10-04-2021,Himachal Pradesh,942833,76850,641,837398,105435,406672,430612,114,2,942831,,581,64575,339527,433193,837398
11-04-2021,Himachal Pradesh,983912,76100,624,876538,107374,425196,451220,122,2,983910,,589,64634,366806,444996,876538
12-04-2021,Himachal Pradesh,1051220,112850,934,940171,111049,454818,485220,133,2,1051218,,597,64775,410615,464677,940171
13-04-2021,Himachal Pradesh,1111863,106850,866,996913,114950,482731,514043,139,2,1111861,,605,65154,449741,481911,996913
14-04-2021,Himachal Pradesh,1157878,105750,908,1039677,118201,503714,535818,145,2,1157876,,611,65270,479216,495085,1039677
15-04-2021,Himachal Pradesh,1192530,80450,677,1070578,121952,518419,552011,148,2,1192528,,610,65316,500596,504559,1070578
16-04-2021,Himachal Pradesh,1241591,78200,645,1112736,128855,538160,574423,153,2,1241589,,617,65526,528949,518154,1112736
17-04-2021,Himachal Pradesh,1278093,66000,546,1143738,134355,553402,590179,157,2,1278091,,618,65710,550212,527710,1143738
18-04-2021,Himachal Pradesh,1289502,41750,328,1153059,136443,558113,594787,159,2,1289500,,620,65754,556609,530590,1153059
19-04-2021,Himachal Pradesh,1328660,82900,703,1184950,143710,573430,611356,164,2,1328658,,622,66029,577468,541345,1184950
20-04-2021,Himachal Pradesh,1378690,89600,730,1225885,152805,593001,632709,175,2,1378688,,628,66383,604288,555106,1225885
21-04-2021,Himachal Pradesh,1400800,93720,845,1244615,156185,602295,642140,180,2,1400798,,630,66491,617033,560985,1244615
22-04-2021,Himachal Pradesh,1451402,95800,824,1286057,165345,621388,664479,190,2,1451400,,635,66812,644548,574590,1286057
23-04-2021,Himachal Pradesh,1497988,99800,848,1322767,175221,639059,683510,198,2,1497986,,639,67232,669652,585772,1322767
24-04-2021,Himachal Pradesh,1537559,61050,531,1354936,182623,655054,699681,201,2,1537557,,642,67418,691397,596008,1354936
25-04-2021,Himachal Pradesh,1548508,30550,268,1363273,185235,659285,703782,206,2,1548506,,643,67490,697007,598663,1363273
26-04-2021,Himachal Pradesh,1593350,88150,769,1396626,196724,675434,720981,211,2,1593348,,647,67691,718070,610748,1396626
27-04-2021,Himachal Pradesh,1644453,86150,718,1434382,210071,693539,740628,215,2,1644451,,648,90486,719472,624303,1434382
28-04-2021,Himachal Pradesh,1689867,96500,887,1468126,221741,709777,758124,225,2,1689865,,650,90905,740868,636229,1468126
29-04-2021,Himachal Pradesh,1743174,83360,765,1505397,237777,727740,777423,234,2,1743172,,652,91430,764004,649887,1505397
30-04-2021,Himachal Pradesh,1793341,76000,657,1541255,252086,745537,795478,240,2,1793339,,653,92025,786601,662546,1541255
01-05-2021,Himachal Pradesh,1823400,63000,545,1562272,261128,756348,805679,245,2,1823398,,653,92655,800172,669362,1562272
02-05-2021,Himachal Pradesh,1828966,28750,239,1566274,262692,758339,807688,247,2,1828964,,653,92492,803127,670601,1566274
03-05-2021,Himachal Pradesh,1874042,82800,732,1595354,278688,772384,822715,255,0,1874042,,655,93121,820829,681350,1595354
04-05-2021,Himachal Pradesh,1920953,95450,788,1624444,296509,786692,837489,263,0,1920953,,656,93669,838664,692054,1624444
05-05-2021,Himachal Pradesh,1956253,90400,783,1645491,310762,797045,848182,264,0,1956253,,658,94370,851499,699565,1645491
06-05-2021,Himachal Pradesh,2005160,101380,893,1671620,333540,809548,861803,269,0,2005160,,659,94878,866748,709936,1671620
07-05-2021,Himachal Pradesh,2037602,84200,724,1688202,349400,818139,869792,271,0,2037602,,659,95297,876713,716134,1688202
08-05-2021,Himachal Pradesh,2058866,81550,704,1699206,359660,823810,875123,273,0,2058866,,659,95927,883134,720085,1699206
09-05-2021,Himachal Pradesh,2065283,60050,507,1702305,362978,825316,876716,273,0,2065283,,660,96013,885085,721146,1702305
10-05-2021,Himachal Pradesh,2097748,92100,808,1717794,379954,833006,884514,274,0,2097748,,660,96480,893685,727532,1717794
11-05-2021,Himachal Pradesh,2125140,92450,786,1730336,394804,839433,890626,277,0,2125140,,660,96973,900567,732672,1730336
12-05-2021,Himachal Pradesh,2141989,76250,667,1740172,401817,844487,895406,279,0,2141989,,662,97602,906153,736278,1740172
13-05-2021,Himachal Pradesh,2175417,75760,677,1757908,417509,853382,904242,284,0,2175417,,663,98198,916704,742827,1757908
14-05-2021,Himachal Pradesh,2191401,73550,623,1767255,424146,858105,908865,285,0,2191401,,663,98684,922392,745995,1767255
15-05-2021,Himachal Pradesh,2217221,72450,636,1784546,432675,866844,917412,290,0,2217221,,663,99754,933414,751173,1784546
16-05-2021,Himachal Pradesh,2220769,33342,218,1787942,432827,868625,919027,290,0,2220769,,663,100200,935475,752059,1787942
17-05-2021,Himachal Pradesh,2243890,71492,599,1810997,432893,882707,927996,294,0,2243890,,663,120528,937413,752831,1810997
18-05-2021,Himachal Pradesh,2265500,109594,648,1832502,432998,895155,937052,295,0,2265500,,664,125682,949383,757206,1832502
19-05-2021,Himachal Pradesh,2281222,84804,457,1848161,433061,904148,943715,298,0,2281222,,665,129764,957823,760327,1848161
20-05-2021,Himachal Pradesh,2304113,74583,631,1871031,433082,918034,952695,302,0,2304113,,665,150732,959194,760850,1871031
21-05-2021,Himachal Pradesh,2323018,114828,670,1889841,433177,929692,959842,307,0,2323018,0,667,157258,968334,763976,1889841
22-05-2021,Himachal Pradesh,2334587,93425,562,1901360,433227,936289,964762,309,0,2334587,0,667,160295,974450,766341,1901360
23-05-2021,Himachal Pradesh,2336772,33120,229,1903533,433239,937536,965688,309,0,2336772,0,667,161007,975497,766755,1903533
24-05-2021,Himachal Pradesh,2358357,60775,489,1925091,433266,950545,974225,321,0,2358357,0,667,181359,976384,767069,1925091
25-05-2021,Himachal Pradesh,2377021,107002,637,1943657,433364,961486,981847,324,0,2377021,0,667,187086,985709,770578,1943657
26-05-2021,Himachal Pradesh,2383941,63035,434,1950536,433405,965667,984545,324,0,2383941,0,667,189547,988869,771834,1950536
27-05-2021,Himachal Pradesh,2405467,47060,369,1972047,433420,978035,993683,329,0,2405467,0,669,209723,989808,772226,1972047
28-05-2021,Himachal Pradesh,2419143,73796,451,1985601,433542,985998,999269,334,0,2419143,0,669,213551,996949,774803,1985601
29-05-2021,Himachal Pradesh,2429862,49796,269,1996254,433608,992440,1003480,334,0,2429862,0,669,217649,1001794,776506,1996254
30-05-2021,Himachal Pradesh,2431191,5140,38,1997579,433612,993431,1003814,334,0,2431191,0,669,218570,1002128,776574,1997579
31-05-2021,Himachal Pradesh,2456257,34883,294,2022636,433621,1007279,1015007,350,0,2456257,0,673,242851,1002702,776768,2022636
01-06-2021,Himachal Pradesh,2471148,53911,308,2037384,433764,1016661,1020372,351,0,2471148,0,673,250455,1008068,778546,2037384
02-06-2021,Himachal Pradesh,2482794,48174,249,2048963,433831,1024007,1024603,353,0,2482794,0,674,257035,1011739,779872,2048963
03-06-2021,Himachal Pradesh,2494074,46570,243,2060164,433910,1030770,1029040,354,0,2494074,0,675,263443,1015274,781129,2060164
04-06-2021,Himachal Pradesh,2509695,52011,278,2075616,434079,1040207,1035037,372,0,2509695,0,675,272995,1019592,782695,2075616
05-06-2021,Himachal Pradesh,2523243,51529,256,2089053,434190,1048356,1040322,375,0,2523243,0,675,280605,1023805,784304,2089053
06-06-2021,Himachal Pradesh,2524493,5160,30,2090289,434204,1049178,1040736,375,0,2524493,0,675,281606,1023994,784350,2090289
07-06-2021,Himachal Pradesh,2536559,49276,248,2102102,434457,1056077,1045649,376,0,2536559,0,675,288975,1027157,785629,2102102
08-06-2021,Himachal Pradesh,2549426,47087,302,2114649,434777,1063833,1050436,380,0,2549426,0,676,296857,1030449,787001,2114649
09-06-2021,Himachal Pradesh,2557978,31271,209,2123031,434947,1068891,1053759,381,0,2557788,190,676,301911,1032830,787947,2123031
10-06-2021,Himachal Pradesh,2566399,30095,204,2131119,435280,1073933,1056802,384,0,2565979,420,676,307175,1034857,788742,2131119
11-06-2021,Himachal Pradesh,2576674,33838,248,2141030,435644,1079787,1060859,384,0,2575974,700,677,313744,1037258,789680,2141030
12-06-2021,Himachal Pradesh,2587927,33289,225,2151953,435974,1086254,1065313,386,0,2586929,998,677,321116,1039774,790709,2151953
13-06-2021,Himachal Pradesh,2588086,911,4,2152111,435975,1086340,1065385,386,0,2587046,1040,677,321216,1039818,790723,2152111
14-06-2021,Himachal Pradesh,2614787,31479,280,2178801,435986,1100729,1077673,399,126,2613401,1260,680,347857,1039841,790731,2178801
15-06-2021,Himachal Pradesh,2659045,63043,542,2222751,436294,1123064,1099271,416,126,2657579,1340,680,389495,1041444,791428,2222751
16-06-2021,Himachal Pradesh,2699523,61709,508,2262895,436628,1143865,1118598,432,238,2697945,1340,680,427910,1042640,791952,2262895
17-06-2021,Himachal Pradesh,2741702,56977,487,2304599,437103,1164597,1139558,444,339,2740023,1340,682,468593,1043258,792333,2304599
18-06-2021,Himachal Pradesh,2793097,81780,553,2354749,438348,1189915,1164361,473,339,2791418,1340,684,515266,1045529,793516,2354749
19-06-2021,Himachal Pradesh,2819145,59072,388,2378841,440304,1201751,1176607,483,413,2817392,1340,685,534929,1048491,794971,2378841
20-06-2021,Himachal Pradesh,2819998,5148,17,2379678,440320,1202274,1176922,482,413,2818085,1500,685,535737,1048509,794980,2379678
21-06-2021,Himachal Pradesh,2918724,133117,839,2478389,440335,1249100,1228764,525,413,2916811,1500,687,634309,1048548,794975,2478389
22-06-2021,Himachal Pradesh,3040740,147653,944,2600380,440360,1306588,1293223,569,674,3038566,1500,688,755814,1048905,795028,2600380
23-06-2021,Himachal Pradesh,3185389,173643,1015,2744942,440447,1374177,1370147,618,1118,3182771,1500,689,899754,1049341,795099,2744942
24-06-2021,Himachal Pradesh,3223393,85406,483,2773268,450125,1390241,1382406,621,1468,3220425,1500,691,914964,1058462,799072,2773268
25-06-2021,Himachal Pradesh,3330049,199730,882,2868066,461983,1671498,1657894,657,1468,3327081,1500,696,1069114,1174446,1086489,2868066
26-06-2021,Himachal Pradesh,3482066,245199,961,3010202,471864,1743262,1738115,689,1495,3479071,1500,699,1202422,1186201,1093443,3010202
27-06-2021,Himachal Pradesh,3497784,25287,54,3025895,471889,1750787,1746305,692,1495,3494789,1500,700,1218037,1186286,1093461,3025895
28-06-2021,Himachal Pradesh,3666915,263428,924,3187698,479217,1827388,1838782,745,1495,3663920,1500,703,1376402,1193738,1096775,3187698
29-06-2021,Himachal Pradesh,3827079,264453,956,3338511,488568,1901290,1925008,781,1543,3824036,1500,705,1524140,1202662,1100277,3338511
30-06-2021,Himachal Pradesh,3866287,91395,419,3351501,514786,1920744,1944757,786,1543,3863244,1500,708,1527701,1227147,1111439,3351501
01-07-2021,Himachal Pradesh,3908924,88012,384,3362065,546859,1940854,1967278,792,1580,3905625,1719,712,1529713,1254768,1124443,3362065
02-07-2021,Himachal Pradesh,3947386,86107,361,3370592,576794,1958864,1987729,793,1580,3943857,1949,713,1531736,1279055,1136595,3370592
03-07-2021,Himachal Pradesh,3985889,81663,355,3378237,607652,1977448,2007641,800,1612,3982015,2262,713,1533956,1303998,1147935,3378237
04-07-2021,Himachal Pradesh,3986005,1500,2,3378319,607686,1977528,2007677,800,1612,3982131,2262,713,1534034,1304022,1147949,3378319
05-07-2021,Himachal Pradesh,4047093,113862,496,3387795,659298,2005623,2040660,810,1612,4043017,2464,714,1535826,1343961,1167306,3387795
06-07-2021,Himachal Pradesh,4115822,132907,626,3398020,717802,2037875,2077124,823,1612,4111516,2694,714,1537963,1389410,1188449,3398020
