Updated On,State,TotalDosesAdministered,TotalSessionsConducted,TotalSites ,FirstDoseAdministered,SecondDoseAdministered,Male,Female,Transgender,Covaxin,CoviShield,SputnikV,AEFI,18_45_years,45_60_years,60_+_years,Total_Individuals_Vaccinated
16-03-2021,Karnataka,1621831,274440,2057,1271286,350545,608554,662594,138,16074,1605757,,2298,449054,369813,451073,1271286
17-03-2021,Karnataka,2013637,427880,3444,1649513,364124,792662,856669,182,21237,1992400,,2306,460322,444273,743513,1649513
18-03-2021,Karnataka,2124428,268930,1958,1752016,372412,842262,909560,194,28245,2096183,,2311,467911,472520,810161,1752016
19-03-2021,Karnataka,2371563,443280,3548,1987433,384130,952427,1034791,215,40560,2331003,,2320,479656,532481,973825,1987433
20-03-2021,Karnataka,2578280,451230,3671,2182510,395770,1044384,1137892,234,66464,2511816,,2328,491694,588747,1100582,2182510
21-03-2021,Karnataka,2611299,144950,1097,2214176,397123,1059302,1154634,240,71413,2539886,,2337,494055,599127,1119499,2214176
22-03-2021,Karnataka,2806130,484730,3936,2399962,406168,1144372,1255328,262,110840,2695290,,2342,501768,647975,1248698,2399962
23-03-2021,Karnataka,2954336,375880,2994,2539195,415141,1209220,1329701,274,161808,2792528,,2344,511092,691509,1335057,2539195
24-03-2021,Karnataka,3140034,514570,4255,2716069,423965,1291036,1424740,293,226117,2913917,,2348,519756,742024,1452734,2716069
25-03-2021,Karnataka,3234506,327530,2592,2805919,428587,1333339,1472280,300,270281,2964225,,2353,524781,771216,1508363,2805919
26-03-2021,Karnataka,3396982,525850,4394,2960802,436180,1405527,1554963,312,323185,3073797,,2358,532652,819060,1607491,2960802
27-03-2021,Karnataka,3522500,447531,3717,3080769,441731,1461483,1618958,328,353843,3168657,,2363,540694,862219,1676249,3080769
28-03-2021,Karnataka,3542620,219350,1768,3100377,442243,1470931,1629114,332,356600,3186020,,2365,542239,869984,1686546,3100377
29-03-2021,Karnataka,3682325,522590,4326,3234131,448194,1531084,1702703,344,378391,3303934,,2368,548729,912209,1771571,3234131
30-03-2021,Karnataka,3800933,452550,3730,3346567,454366,1581954,1764252,361,395682,3405251,,2373,555147,953554,1836227,3346567
31-03-2021,Karnataka,3952215,541080,4529,3489527,462688,1647009,1842139,379,412737,3539478,,2379,563318,1004149,1920381,3489527
01-04-2021,Karnataka,4066715,452680,3875,3599566,467149,1698361,1900816,389,425440,3641275,,2381,567373,1067206,1963298,3599566
02-04-2021,Karnataka,4266426,514400,4568,3793071,473355,1788626,2004033,412,442763,3823663,,2386,573707,1185018,2032646,3793071
03-04-2021,Karnataka,4450751,591470,5431,3971518,479233,1871702,2099382,434,454895,3995856,,2388,579191,1292667,2097951,3971518
04-04-2021,Karnataka,4592345,510310,4510,4108669,483676,1936005,2172207,457,464461,4127884,,2396,583070,1380617,2143269,4108669
05-04-2021,Karnataka,4765091,675771,6103,4274168,490923,2009976,2263714,478,478207,4286884,,2401,583316,1480104,2209031,4274168
06-04-2021,Karnataka,4874443,705350,6304,4378738,495705,2057498,2320752,488,491658,4382785,,2405,583468,1546571,2246979,4378738
07-04-2021,Karnataka,5193089,743223,6734,4681696,511393,2194018,2487150,528,522784,4670305,,2417,583935,1734612,2361430,4681696
08-04-2021,Karnataka,5463170,739551,6527,4936256,526914,2310232,2625464,560,541190,4921980,,2426,584226,1893421,2456890,4936256
09-04-2021,Karnataka,5788229,817850,7338,5241266,546963,2451971,2788693,602,555182,5233047,,2434,586619,2086069,2566857,5241266
10-04-2021,Karnataka,6066457,752250,6838,5502062,564395,2575155,2926258,649,566845,5499612,,2442,589227,2254327,2656782,5502062
11-04-2021,Karnataka,6208540,692240,6163,5635988,572552,2640037,2995283,668,572077,5636463,,2449,590532,2340569,2703160,5635988
12-04-2021,Karnataka,6407151,779510,6980,5814005,593146,2729159,3084145,701,578395,5828756,,2457,593719,2454248,2764307,5814005
13-04-2021,Karnataka,6446449,679710,6051,5848181,598268,2747459,3100011,711,580152,5866297,,2460,594496,2477094,2774859,5848181
14-04-2021,Karnataka,6550378,702910,6246,5935191,615187,2789071,3145397,723,585978,5964400,,2463,595473,2533761,2804222,5935191
15-04-2021,Karnataka,6704302,713610,6219,6060959,643343,2847597,3212623,739,595970,6108332,,2467,597673,2611371,2850173,6060959
16-04-2021,Karnataka,6910211,753660,6538,6226534,683677,2925945,3299828,761,613354,6296857,,2471,601463,2714568,2908765,6226534
17-04-2021,Karnataka,7191885,740050,6682,6449119,742766,3031185,3417138,796,642055,6549830,,2474,606671,2855049,2985658,6449119
18-04-2021,Karnataka,7296541,707510,6265,6532361,764180,3071706,3459851,804,654574,6641967,,2476,608452,2908828,3013337,6532361
19-04-2021,Karnataka,7542740,810010,7256,6710926,831814,3157425,3552673,828,688768,6853972,,2478,613534,3016712,3078937,6710926
20-04-2021,Karnataka,7768341,829600,7385,6871164,897177,3236053,3634252,859,723260,7045081,,2482,619385,3114152,3135887,6871164
21-04-2021,Karnataka,7957698,774590,6960,7004724,952974,3302074,3701769,881,753927,7203771,,2487,624778,3195370,3182837,7004724
22-04-2021,Karnataka,8189265,802100,7148,7158532,1030733,3378086,3779537,909,788176,7401089,,2489,631531,3289216,3236032,7158532
23-04-2021,Karnataka,8446284,826360,7407,7334071,1112213,3469082,3864056,933,829495,7616789,,2493,642102,3398784,3291423,7334071
24-04-2021,Karnataka,8592838,700250,6474,7439115,1153723,3526465,3911703,947,854160,7738678,,2493,647456,3467982,3321906,7439115
25-04-2021,Karnataka,8673546,705670,6449,7495232,1178314,3556456,3937819,957,861190,7812356,,2493,650043,3504285,3339129,7495232
26-04-2021,Karnataka,8892099,763690,6974,7631765,1260334,3626966,4003824,975,882421,8009678,,2495,657068,3587685,3385235,7631765
27-04-2021,Karnataka,9088000,782540,7108,7750770,1337230,3687912,4061863,995,896837,8191163,,2496,810340,3513734,3424909,7750770
28-04-2021,Karnataka,9276973,698750,6546,7864503,1412470,3746951,4116541,1011,908939,8368034,,2496,818650,3581901,3462155,7864503
29-04-2021,Karnataka,9400272,701840,6501,7940695,1459577,3788002,4151668,1025,920031,8480241,,2496,825212,3628975,3485037,7940695
30-04-2021,Karnataka,9642439,749050,7030,8090917,1551522,3868438,4221433,1046,930091,8712348,,2497,838459,3720768,3530178,8090917
01-05-2021,Karnataka,9776943,631535,6053,8178490,1598453,3915651,4261784,1055,935680,8841263,,2499,847149,3775336,3554491,8178490
02-05-2021,Karnataka,9817518,532150,5106,8204770,1612748,3929605,4274104,1061,938372,8879146,,2499,844933,3797125,3561286,8204770
03-05-2021,Karnataka,9901051,649720,6155,8253648,1647403,3956396,4296182,1070,944843,8956208,,2501,851427,3825697,3575095,8253648
04-05-2021,Karnataka,9962735,615350,5857,8289078,1673657,3975921,4312066,1091,950466,9012269,,2501,857692,3845675,3584267,8289078
05-05-2021,Karnataka,10150823,715825,6731,8387120,1763703,4028325,4357686,1109,955020,9195803,,2502,870392,3901947,3613333,8387120
06-05-2021,Karnataka,10314190,665650,6306,8468403,1845787,4072788,4394486,1129,960947,9353243,,2504,883378,3947529,3636041,8468403
07-05-2021,Karnataka,10450470,729950,6822,8527328,1923142,4104609,4421578,1141,974772,9475698,,2506,892731,3978895,3654245,8527328
08-05-2021,Karnataka,10596894,694450,6532,8577077,2019817,4129814,4446112,1151,996834,9600060,,2505,900271,4004044,3671301,8577077
09-05-2021,Karnataka,10643323,580800,5579,8591372,2051951,4137053,4453164,1155,1005810,9637513,,2507,902905,4011205,3675799,8591372
10-05-2021,Karnataka,10772140,683600,6375,8638830,2133310,4162385,4475284,1161,1019608,9752532,,2510,917054,4029967,3690259,8638830
11-05-2021,Karnataka,10963129,616070,5596,8718545,2244584,4207074,4510291,1180,1029732,9933397,,2512,950533,4057444,3708914,8718545
12-05-2021,Karnataka,11102044,602683,5509,8792803,2309241,4248850,4542762,1191,1040062,10061982,,2513,984192,4082490,3724394,8792803
13-05-2021,Karnataka,11205478,540350,4932,8851449,2354029,4282464,4567779,1206,1050609,10154869,,2515,1019143,4097451,3733090,8851449
14-05-2021,Karnataka,11296508,563300,5332,8885120,2411388,4299852,4584048,1220,1064149,10232359,,2515,1026689,4112585,3744042,8885120
15-05-2021,Karnataka,11424456,663200,6150,8927204,2497252,4321103,4604869,1232,1100992,10323464,,2516,1036303,4131870,3757154,8927204
16-05-2021,Karnataka,11448846,512946,4641,8942960,2505886,4329123,4612604,1233,1110213,10338633,,2516,1038989,4140964,3761117,8942960
17-05-2021,Karnataka,11543880,691059,5780,9017346,2526534,4368939,4647160,1247,1132318,10411562,,2518,1050113,4187310,3777969,9017346
18-05-2021,Karnataka,11629177,645187,5381,9091077,2538100,4408566,4681252,1259,1145476,10483701,,2521,1062623,4233121,3793325,9091077
19-05-2021,Karnataka,11714719,658018,5183,9162909,2551810,4447633,4714002,1274,1164652,10550067,,2521,1077966,4275303,3807587,9162909
20-05-2021,Karnataka,11800829,687539,5186,9228494,2572335,4483874,4743327,1293,1194325,10606504,,2522,1094743,4311852,3819793,9228494
21-05-2021,Karnataka,11909365,737343,5433,9307694,2601671,4527899,4778492,1303,1235124,10674241,0,2523,1115571,4355829,3834131,9307694
22-05-2021,Karnataka,12024591,802712,5443,9407939,2616652,4585205,4821418,1316,1258645,10765946,0,2524,1153521,4402999,3849150,9407939
23-05-2021,Karnataka,12090122,654657,4493,9468988,2621134,4622136,4845530,1322,1264260,10825862,0,2524,1187455,4423651,3855518,9468988
24-05-2021,Karnataka,12245538,909171,5523,9612835,2632703,4711060,4900416,1359,1280434,10965104,0,2526,1270697,4469404,3870221,9612835
25-05-2021,Karnataka,12412615,1005051,5439,9770531,2642084,4812574,4956588,1369,1293886,11118729,0,2527,1383685,4503561,3880639,9770531
26-05-2021,Karnataka,12592227,1115314,5795,9939939,2652288,4920646,5017905,1388,1307789,11284438,0,2528,1496490,4546853,3893722,9939939
27-05-2021,Karnataka,12825223,1185146,5520,10154372,2670851,5052063,5100876,1433,1337833,11487390,0,2528,1635875,4603441,3911921,10154372
28-05-2021,Karnataka,13092345,1255788,5746,10393577,2698768,5199787,5192314,1476,1378841,11713504,0,2528,1792515,4664922,3932691,10393577
29-05-2021,Karnataka,13346630,1196473,4979,10625599,2721031,5339822,5284257,1520,1416080,11930550,0,2530,1951062,4719698,3951109,10625599
30-05-2021,Karnataka,13439808,898354,3850,10709480,2730328,5389899,5318046,1535,1432867,12006941,0,2531,2011006,4737652,3956994,10709480
31-05-2021,Karnataka,13683390,1243336,4934,10929687,2753703,5519056,5409055,1576,1472981,12210409,0,2532,2154044,4795180,3976306,10929687
01-06-2021,Karnataka,13906541,1234927,4173,11133566,2772975,5639451,5492499,1616,1510138,12396403,0,2532,2293839,4843052,3992170,11133566
02-06-2021,Karnataka,14154710,1315234,4355,11363561,2791149,5772731,5589178,1652,1547710,12607000,0,2534,2452847,4895967,4009942,11363561
03-06-2021,Karnataka,14407706,1378346,4452,11596660,2811046,5908628,5686351,1681,1584906,12822800,0,2534,2626093,4939870,4025477,11596660
04-06-2021,Karnataka,14735361,1616711,5043,11899361,2836000,6081337,5816194,1830,1624209,13111152,0,2535,2838700,5006585,4048250,11899361
05-06-2021,Karnataka,15068597,1680845,5276,12206183,2862414,6253471,5950834,1878,1665088,13403436,73,2540,3034401,5089306,4076171,12206183
06-06-2021,Karnataka,15203304,1144187,3719,12333182,2870122,6321434,6009848,1900,1676132,13526684,488,2541,3122648,5118143,4085918,12333182
07-06-2021,Karnataka,15504527,1607382,5113,12612607,2891920,6475386,6135260,1961,1702136,13801567,824,2542,3296754,5195770,4113287,12612607
08-06-2021,Karnataka,15759842,1565975,4827,12847608,2912234,6605473,6240139,1996,1726068,14032950,824,2542,3435398,5266009,4139033,12847608
09-06-2021,Karnataka,15992599,1416620,4675,13058077,2934522,6723942,6332072,2063,1750005,14241770,824,2543,3552334,5333738,4164471,13058077
10-06-2021,Karnataka,16249047,1469398,4746,13294675,2954372,6856194,6436314,2167,1770493,14477695,859,2543,3714413,5388278,4184124,13294675
11-06-2021,Karnataka,16580369,1647571,5352,13599544,2980825,7026110,6571195,2239,1794208,14785131,1030,2546,3915718,5463457,4212097,13599544
12-06-2021,Karnataka,16892231,1700787,5196,13885050,3007181,7178609,6704132,2309,1815645,15075457,1129,2546,4095058,5541060,4240264,13885050
13-06-2021,Karnataka,16998892,1100020,3654,13985016,3013876,7231381,6751302,2333,1820512,15177251,1129,2545,4156213,5569411,4250654,13985016
14-06-2021,Karnataka,17262828,1662102,5331,14219979,3042849,7354643,6862965,2371,1834806,15426838,1184,2547,4290816,5639877,4280208,14219979
15-06-2021,Karnataka,17482779,1559385,4984,14412058,3070721,7455978,6953636,2444,1848603,15632932,1244,2548,4394010,5703486,4305220,14412058
16-06-2021,Karnataka,17695431,1533625,4953,14594061,3101370,7551718,7039881,2462,1865062,15829065,1304,2549,4487282,5766880,4330302,14594061
17-06-2021,Karnataka,17899357,1503107,4668,14771770,3127587,7646015,7123213,2542,1879415,16018602,1340,2552,4605389,5809230,4347353,14771770
18-06-2021,Karnataka,18130798,1570993,4949,14971193,3159605,7755170,7213383,2640,1899297,16230106,1395,2553,4747758,5850127,4363167,14971193
19-06-2021,Karnataka,18421390,1685106,5240,15205385,3216005,7879659,7322978,2748,1924681,16495243,1466,2555,4874433,5926345,4394072,15205385
20-06-2021,Karnataka,18498363,1140306,3433,15268722,3229641,7911405,7354556,2761,1931696,16565201,1466,2556,4906306,5948661,4403122,15268722
21-06-2021,Karnataka,19652759,5771130,8289,16339169,3313590,8436925,7899250,2994,2079183,17571984,1592,2555,5678809,6156007,4493099,16339169
22-06-2021,Karnataka,20104474,3028443,5681,16752226,3352248,8643425,8105735,3066,2175629,17927104,1741,2554,5995262,6223353,4522076,16752226
23-06-2021,Karnataka,20512334,2878089,5397,17126371,3385963,8825765,8297437,3169,2252981,18257444,1909,2556,6276205,6287671,4550692,17126371
24-06-2021,Karnataka,20921155,3045541,5351,17493598,3427557,9008235,8482128,3235,2319494,18599539,2122,2559,6562740,6343488,4575291,17493598
25-06-2021,Karnataka,21341517,3235949,5483,17864741,3476776,10896930,10441087,3500,2401636,18937409,2472,2563,7472496,7621943,6247078,17864741
26-06-2021,Karnataka,21622289,2949768,4412,18089135,3533154,11038098,10580653,3538,2481521,19137845,2923,2564,7673782,7675751,6272756,18089135
27-06-2021,Karnataka,21750366,2293791,3397,18196068,3554298,11101463,10645349,3554,2513450,19233993,2923,2565,7766278,7700286,6283802,18196068
28-06-2021,Karnataka,22202542,3842599,5545,18563185,3639357,11313004,10885911,3627,2627009,19571719,3814,2568,8075153,7792503,6334886,18563185
29-06-2021,Karnataka,22470761,3283583,4610,18787206,3683555,11441952,11025086,3723,2718274,19748000,4487,2568,8275888,7837705,6357168,18787206
30-06-2021,Karnataka,22712414,3248246,4304,18973039,3739375,11561732,11146911,3771,2787439,19919959,5016,2572,8449511,7883291,6379612,18973039
01-07-2021,Karnataka,22911665,2959202,3432,19124712,3786953,11659353,11248515,3797,2841636,20064363,5666,2577,8590631,7921821,6399213,19124712
02-07-2021,Karnataka,23152094,3268266,3841,19293267,3858827,11778594,11369656,3844,2903238,20242202,6654,2582,8751776,7975159,6425159,19293267
03-07-2021,Karnataka,23639206,4021088,5307,19601804,4037402,12014922,11620361,3923,2984583,20647210,7413,2583,9030964,8113023,6495219,19601804
04-07-2021,Karnataka,23790590,2740122,3206,19703988,4086602,12088606,11698043,3941,3001217,20781811,7562,2594,9116341,8157977,6516272,19703988
05-07-2021,Karnataka,24185562,3860154,5267,19965810,4219752,12278484,11903067,4011,3045981,21131204,8377,2595,9347226,8265606,6572730,19965810
06-07-2021,Karnataka,24477242,3505965,4671,20169876,4307366,12419827,12053357,4058,3077523,21390621,9098,2595,9527211,8340217,6609814,20169876
