Updated On,State,TotalDosesAdministered,TotalSessionsConducted,TotalSites ,FirstDoseAdministered,SecondDoseAdministered,Male,Female,Transgender,Covaxin,CoviShield,SputnikV,AEFI,18_45_years,45_60_years,60_+_years,Total_Individuals_Vaccinated
16-03-2021,Kerala,1500473,193345,1385,1188099,312374,506856,681178,65,82435,1418038,,1902,374000,455351,358304,1188099
17-03-2021,Kerala,2016703,117310,846,1695387,321316,768897,926350,140,89070,1927633,,1922,378681,487885,828313,1695387
18-03-2021,Kerala,2165652,205825,1439,1832205,333447,834871,997172,162,95005,2070647,,1928,386607,501613,943454,1832205
19-03-2021,Kerala,2298455,205740,1474,1954868,343587,892887,1061807,174,101174,2197281,,1941,393442,513029,1047850,1954868
20-03-2021,Kerala,2418931,190250,1365,2066624,352307,944605,1121838,181,107378,2311553,,1955,399459,523703,1142906,2066624
21-03-2021,Kerala,2426827,18950,121,2073902,352925,948016,1125704,182,107808,2319019,,1956,399879,524512,1148954,2073902
22-03-2021,Kerala,2564049,223760,1580,2203735,360314,1008762,1194773,200,113327,2450722,,1979,404097,534800,1264269,2203735
23-03-2021,Kerala,2712712,222431,1574,2339164,373548,1071966,1266982,216,124751,2587961,,2001,408808,546705,1383069,2339164
24-03-2021,Kerala,2776155,117740,824,2398567,377588,1099916,1298425,226,127294,2648861,,2005,411519,552346,1434110,2398567
25-03-2021,Kerala,2939242,228540,1552,2555550,383692,1173561,1381745,244,131207,2808035,,2024,416361,563722,1574867,2555550
26-03-2021,Kerala,3070352,215440,1533,2682089,388263,1231380,1450450,259,133243,2937109,,2040,420884,573409,1687188,2682089
27-03-2021,Kerala,3188068,193450,1397,2795930,392138,1283227,1512430,273,135202,3052866,,2052,425319,586631,1783366,2795930
28-03-2021,Kerala,3199659,44970,342,2807351,392308,1288539,1518538,274,135210,3064449,,2053,425671,588086,1792979,2807351
29-03-2021,Kerala,3353041,222970,1563,2956227,396814,1355104,1600818,305,136924,3216117,,2061,429603,606659,1919332,2956227
30-03-2021,Kerala,3510207,240701,1588,3106682,403525,1421478,1684885,319,139738,3370469,,2072,433707,628610,2043721,3106682
31-03-2021,Kerala,3574857,159940,1071,3167015,407842,1448053,1718636,326,141297,3433560,,2082,436365,642543,2087461,3167015
01-04-2021,Kerala,3653814,170390,1173,3242747,411067,1481276,1761139,332,141781,3512033,,2089,438433,680966,2122699,3242747
02-04-2021,Kerala,3721899,117886,805,3307374,414525,1510014,1797019,341,142408,3579491,,2095,440164,718525,2148027,3307374
03-04-2021,Kerala,3838483,195200,1400,3416400,422083,1555388,1860659,353,143446,3695037,,2105,442162,781457,2192120,3416400
04-04-2021,Kerala,3888331,66010,458,3463563,424768,1575071,1888134,358,143892,3744439,,2107,443088,810067,2209745,3463563
05-04-2021,Kerala,4005217,218935,1570,3573568,431649,1620368,1952832,368,144425,3860792,,2118,443204,874414,2255286,3573568
06-04-2021,Kerala,4042344,93940,713,3608126,434218,1635201,1972554,371,144684,3897660,,2123,443270,895600,2268591,3608126
07-04-2021,Kerala,4140687,201340,1308,3698854,441833,1673913,2024554,387,145437,3995250,,2137,443420,953134,2301634,3698854
08-04-2021,Kerala,4356948,259252,1692,3899533,457415,1757681,2141438,414,146408,4210540,,2157,443767,1074369,2380727,3899533
09-04-2021,Kerala,4575579,262105,1730,4099009,476570,1841931,2256641,437,147850,4427729,,2168,444541,1201366,2452428,4099009
10-04-2021,Kerala,4763750,224225,1520,4270854,492896,1915320,2355073,461,149328,4614422,,2178,445246,1313963,2510969,4270854
11-04-2021,Kerala,4830666,134861,867,4333798,496868,1944347,2388985,466,149990,4680676,,2184,445378,1355327,2532414,4333798
12-04-2021,Kerala,5098015,290180,1822,4571524,526491,2045082,2525926,516,152985,4945030,,2195,446438,1502254,2622148,4571524
13-04-2021,Kerala,5267173,271852,1736,4714085,553088,2109225,2604323,537,156460,5110713,,2205,447508,1592577,2673315,4714085
14-04-2021,Kerala,5287486,118910,900,4730173,557313,2117216,2612419,538,157699,5129787,,2207,447642,1602880,2678965,4730173
15-04-2021,Kerala,5496553,245990,1658,4899502,597051,2193316,2705623,563,172708,5323845,,2221,448708,1713396,2736720,4899502
16-04-2021,Kerala,5680114,217590,1531,5040807,639307,2257490,2782737,580,199162,5480952,,2251,449799,1807572,2782761,5040807
17-04-2021,Kerala,5832548,154580,1165,5158591,673957,2312598,2845392,601,240926,5591622,,2264,451199,1888038,2818675,5158591
18-04-2021,Kerala,5870232,122710,880,5189796,680436,2328909,2860281,606,255745,5614487,,2264,451415,1909315,2828387,5189796
19-04-2021,Kerala,6026332,203991,1441,5299053,727279,2381261,2917173,619,288756,5737576,,2272,452951,1981397,2864026,5299053
20-04-2021,Kerala,6243615,192246,1429,5443386,800229,2449699,2993054,633,312000,5931615,,2278,454948,2077264,2910496,5443386
21-04-2021,Kerala,6353600,170365,1213,5512304,841296,2483037,3028625,642,322945,6030655,,2288,456096,2122327,2933201,5512304
22-04-2021,Kerala,6503034,172874,1301,5602945,900089,2525828,3076458,659,333703,6169331,,2298,457658,2181702,2962902,5602945
23-04-2021,Kerala,6628388,172728,1247,5673943,954445,2559741,3113525,677,339373,6289015,,2300,459063,2228506,2985696,5673943
24-04-2021,Kerala,6827755,205317,1310,5788568,1039187,2615457,3172415,696,343411,6484344,,2301,460467,2305785,3021630,5788568
25-04-2021,Kerala,6847075,80837,597,5801281,1045794,2621806,3178777,698,344350,6502725,,2301,460544,2314002,3026049,5801281
26-04-2021,Kerala,6991118,180172,1325,5885170,1105948,2662083,3222372,715,349708,6641410,,2304,462008,2369111,3053362,5885170
27-04-2021,Kerala,7106942,146869,1075,5947361,1159581,2691909,3254720,732,352774,6754168,,2307,616768,2255283,3074625,5947361
28-04-2021,Kerala,7144083,62950,475,5967887,1176196,2701673,3265481,733,362293,6781790,,2311,617376,2268382,3081442,5967887
29-04-2021,Kerala,7229177,93760,731,6006391,1222786,2720059,3285590,742,368302,6860875,,2314,618567,2292415,3095020,6006391
30-04-2021,Kerala,7376934,154900,1141,6051350,1325584,2741857,3308741,752,375938,7000996,,2319,620532,2318284,3112082,6051350
01-05-2021,Kerala,7425416,69210,594,6069726,1355690,2750902,3318069,755,382103,7043313,,2319,621053,2329584,3118636,6069726
02-05-2021,Kerala,7426176,18200,156,6069760,1356416,2750908,3318097,755,382111,7044065,,2319,619769,2331017,3118641,6069760
03-05-2021,Kerala,7511454,106630,869,6092349,1419105,2761697,3329892,760,387629,7123825,,2321,620875,2343224,3127917,6092349
04-05-2021,Kerala,7577304,98340,767,6110419,1466885,2770380,3339264,775,396731,7180573,,2323,621803,2353344,3134926,6110419
05-05-2021,Kerala,7600484,59670,455,6118358,1482126,2774337,3343245,776,402333,7198151,,2323,622368,2358023,3137621,6118358
06-05-2021,Kerala,7705285,120290,945,6137985,1567300,2784001,3353206,778,407131,7298154,,2326,623864,2367398,3146378,6137985
07-05-2021,Kerala,7869269,167350,1157,6168780,1700489,2799186,3368802,792,412346,7456923,,2327,626402,2381677,3160352,6168780
08-05-2021,Kerala,7951983,120005,971,6187280,1764703,2808977,3377510,793,416141,7535842,,2329,628571,2390586,3167770,6187280
09-05-2021,Kerala,7952556,27900,254,6187652,1764904,2809173,3377686,793,416217,7536339,,2329,628575,2390835,3167889,6187652
10-05-2021,Kerala,8066700,132060,992,6216882,1849818,2824070,3392015,797,423755,7642945,,2329,630925,2405009,3180345,6216882
11-05-2021,Kerala,8141289,105890,825,6238776,1902513,2835199,3402776,801,431710,7709579,,2332,632656,2415549,3189813,6238776
12-05-2021,Kerala,8185506,67230,511,6257014,1928492,2844396,3411815,803,445050,7740456,,2333,633909,2425732,3196542,6257014
13-05-2021,Kerala,8212961,62660,473,6267551,1945410,2849994,3416754,803,451210,7761751,,2333,635136,2431388,3200126,6267551
14-05-2021,Kerala,8259812,76660,549,6290354,1969458,2861504,3428041,809,465390,7794422,,2334,636611,2444930,3207813,6290354
15-05-2021,Kerala,8417840,193340,1222,6426197,1991643,2929192,3496162,843,503057,7914783,,2338,640420,2527786,3256481,6426197
16-05-2021,Kerala,8451480,62347,248,6454137,1997343,2943348,3509943,846,525938,7925542,,2338,642438,2545465,3264646,6454137
17-05-2021,Kerala,8519852,126134,711,6510777,2009075,2971971,3537933,873,560846,7959006,,2338,645424,2576386,3287242,6510777
18-05-2021,Kerala,8573567,107114,689,6556628,2016939,2995543,3560206,879,583045,7990522,,2340,649389,2602358,3303043,6556628
19-05-2021,Kerala,8591102,47086,427,6571984,2019118,3003719,3567381,884,590468,8000634,,2341,652401,2609555,3308153,6571984
20-05-2021,Kerala,8599407,34433,351,6579668,2019739,3007834,3570949,885,593912,8005495,,2344,654929,2612645,3310191,6579668
21-05-2021,Kerala,8614950,48961,447,6594479,2020471,3016029,3577562,888,603174,8011776,0,2344,660600,2618484,3313439,6594479
22-05-2021,Kerala,8644281,89493,725,6623765,2020516,3031911,3590961,893,605554,8038727,0,2344,672240,2630270,3319195,6623765
23-05-2021,Kerala,8650237,17594,158,6629725,2020512,3035800,3593032,893,607283,8042954,0,2344,676883,2631157,3319591,6629725
24-05-2021,Kerala,8703631,113572,888,6683003,2020628,3067418,3614688,897,613100,8090531,0,2346,704765,2647984,3328015,6683003
25-05-2021,Kerala,8759506,120035,878,6738751,2020755,3098253,3639577,921,618253,8141253,0,2349,727882,2669935,3338590,6738751
26-05-2021,Kerala,8789981,69295,546,6769136,2020845,3116944,3651267,925,620297,8169684,0,2351,746447,2677877,3342371,6769136
27-05-2021,Kerala,8904096,173879,987,6881450,2022646,3178296,3702207,947,624269,8279827,0,2357,773634,2735438,3369608,6881450
28-05-2021,Kerala,9056314,232312,1107,7031363,2024951,3257463,3772920,980,628104,8428210,0,2361,802643,2814700,3410877,7031363
29-05-2021,Kerala,9215371,238231,1124,7170607,2044764,3333564,3836030,1013,649344,8566027,0,2362,840758,2883246,3443138,7170607
30-05-2021,Kerala,9241456,42017,147,7190905,2050551,3345454,3844431,1020,655352,8586104,0,2363,851898,2889453,3446016,7190905
31-05-2021,Kerala,9413723,272069,1237,7345141,2068582,3434903,3909178,1060,676006,8737717,0,2368,912167,2950616,3478379,7345141
01-06-2021,Kerala,9583560,299704,1284,7494522,2089038,3524752,3968676,1094,699631,8883929,0,2368,980600,3003561,3506031,7494522
02-06-2021,Kerala,9689249,209924,841,7585560,2103689,3579264,4005189,1107,718474,8970775,0,2375,1024242,3033437,3523342,7585560
03-06-2021,Kerala,9850288,295836,1214,7730989,2119299,3660864,4068986,1139,735829,9114459,0,2376,1076446,3094628,3554988,7730989
04-06-2021,Kerala,10026627,320606,1218,7888884,2137743,3748295,4139368,1221,754258,9272350,19,2378,1135362,3159749,3588358,7888884
05-06-2021,Kerala,10214963,354755,1279,8057972,2156991,3837947,4218767,1258,773840,9441101,22,2387,1187696,3233961,3630418,8057972
06-06-2021,Kerala,10270131,119620,341,8109567,2160564,3864762,4243531,1274,780025,9490084,22,2390,1222658,3244830,3636049,8109567
07-06-2021,Kerala,10473049,387925,1269,8302066,2170983,3968931,4331808,1327,812130,9660897,22,2396,1331763,3296604,3667093,8302066
08-06-2021,Kerala,10692008,428385,1394,8503125,2188883,4069339,4432407,1379,860159,9831827,22,2400,1460041,3342897,3693029,8503125
09-06-2021,Kerala,10832105,313298,1078,8634128,2197977,4136007,4496716,1405,896410,9935673,22,2401,1547412,3370510,3708731,8634128
10-06-2021,Kerala,10983039,339007,1185,8772285,2210754,4208856,4561993,1436,941498,10041519,22,2402,1620269,3414127,3730000,8772285
11-06-2021,Kerala,11102819,294518,1102,8879020,2223799,4262724,4614836,1460,985965,10116832,22,2403,1679209,3444621,3747048,8879020
12-06-2021,Kerala,11181355,248698,786,8943648,2237707,4296746,4645429,1473,1013894,10167439,22,2403,1721861,3458627,3754874,8943648
13-06-2021,Kerala,11229829,131106,413,8989689,2240140,4322088,4666124,1477,1017425,10212382,22,2403,1763606,3461556,3756065,8989689
14-06-2021,Kerala,11422135,379790,1344,9154064,2268071,4411531,4741027,1506,1037536,10384577,22,2405,1874682,3494981,3775497,9154064
15-06-2021,Kerala,11635416,424663,1301,9307169,2328247,4488313,4817314,1542,1051381,10584013,22,2405,1914838,3562118,3820770,9307169
16-06-2021,Kerala,11746936,243440,923,9386066,2360870,4529099,4855411,1556,1056130,10690784,22,2408,1946564,3590195,3839598,9386066
17-06-2021,Kerala,11895426,320096,1239,9504983,2390443,4590268,4913131,1584,1063048,10832356,22,2410,2023869,3614621,3856369,9504983
18-06-2021,Kerala,11996311,255798,947,9589345,2406966,4632365,4955377,1603,1070485,10925804,22,2413,2082250,3629517,3867195,9589345
19-06-2021,Kerala,12103202,245704,1002,9676904,2426298,4676553,4998721,1630,1075660,11027520,22,2413,2125774,3654958,3885514,9676904
20-06-2021,Kerala,12161549,125141,331,9719116,2442433,4697169,5020309,1638,1078411,11083116,22,2414,2139319,3671773,3897187,9719116
21-06-2021,Kerala,12431202,591187,1543,9878112,2553090,4774418,5101989,1705,1092178,11339002,22,2418,2194277,3729702,3942402,9878112
22-06-2021,Kerala,12668936,546122,1531,10022247,2646689,4845812,5174699,1736,1106631,11562283,22,2419,2250956,3778391,3980566,10022247
23-06-2021,Kerala,12837481,364068,1133,10116957,2720524,4891573,5223627,1757,1126110,11711349,22,2420,2287145,3810337,4006771,10116957
24-06-2021,Kerala,13061640,492490,1418,10258975,2802665,4961637,5295553,1785,1142238,11919380,22,2422,2335523,3863683,4046483,10258975
25-06-2021,Kerala,13304025,528180,1472,10402196,2901829,6385464,6916521,2040,1154293,12149710,22,2428,2897446,4606546,5800033,10402196
26-06-2021,Kerala,13483338,398389,1234,10506089,2977249,6472367,7008893,2078,1169758,12313558,22,2429,2942936,4668663,5871739,10506089
27-06-2021,Kerala,13535878,135036,274,10541450,2994428,6498966,7034828,2084,1174572,12361080,226,2429,2962823,4683989,5889066,10541450
28-06-2021,Kerala,13748651,438168,1361,10649612,3099039,6599361,7147179,2111,1195791,12552616,244,2432,3011346,4760177,5977128,10649612
29-06-2021,Kerala,13948645,420048,1412,10748505,3200140,6693041,7253459,2145,1211737,12736664,244,2432,3060526,4825439,6062680,10748505
30-06-2021,Kerala,14095726,333990,954,10841514,3254212,6766583,7326970,2173,1225695,12869253,778,2438,3126977,4866538,6102211,10841514
01-07-2021,Kerala,14242696,272859,1136,10915717,3326979,6837049,7403404,2243,1243834,12997960,902,2448,3171552,4913360,6157784,10915717
02-07-2021,Kerala,14531577,507450,1598,11043945,3487632,6975234,7554037,2306,1260906,13269769,902,2452,3246781,5019219,6265577,11043945
03-07-2021,Kerala,14764538,434026,1349,11162817,3601721,7085967,7676234,2337,1286057,13477539,942,2454,3309896,5113362,6341280,11162817
04-07-2021,Kerala,14790452,60703,204,11179952,3610500,7099481,7688630,2341,1296452,13492969,1031,2456,3322602,5121262,6346588,11179952
05-07-2021,Kerala,14947001,280390,1126,11261270,3685731,7180664,7763956,2381,1322560,13622811,1630,2456,3380896,5175120,6390985,11261270
06-07-2021,Kerala,15062316,210822,956,11322761,3739555,7237725,7822183,2408,1344479,13715852,1985,2458,3421480,5215031,6425805,11322761
