Updated On,State,TotalDosesAdministered,TotalSessionsConducted,TotalSites ,FirstDoseAdministered,SecondDoseAdministered,Male,Female,Transgender,Covaxin,CoviShield,SputnikV,AEFI,18_45_years,45_60_years,60_+_years,Total_Individuals_Vaccinated
16-03-2021,Lakshadweep,3860,1000,10,2753,1107,2089,664,0,0,3860,,0,1059,1136,558,2753
17-03-2021,Lakshadweep,4555,900,9,3420,1135,2492,928,0,0,4555,,0,1069,1266,1085,3420
18-03-2021,Lakshadweep,4904,800,8,3617,1287,2652,965,0,0,4904,,0,1102,1395,1120,3617
19-03-2021,Lakshadweep,5088,900,9,3735,1353,2722,1013,0,0,5088,,0,1139,1437,1159,3735
20-03-2021,Lakshadweep,5387,1000,10,3915,1472,2818,1097,0,0,5387,,0,1218,1497,1200,3915
21-03-2021,Lakshadweep,5394,0,0,3920,1474,2822,1098,0,0,5394,,0,1220,1500,1200,3920
22-03-2021,Lakshadweep,5521,1000,10,4018,1503,2881,1137,0,0,5521,,0,1231,1543,1244,4018
23-03-2021,Lakshadweep,5707,900,9,4145,1562,2949,1196,0,0,5707,,0,1260,1588,1297,4145
24-03-2021,Lakshadweep,5826,800,8,4233,1593,3007,1226,0,0,5826,,0,1278,1620,1335,4233
25-03-2021,Lakshadweep,5901,900,9,4277,1624,3027,1250,0,0,5901,,0,1289,1641,1347,4277
26-03-2021,Lakshadweep,6053,800,8,4405,1648,3098,1307,0,0,6053,,0,1306,1675,1424,4405
27-03-2021,Lakshadweep,6266,900,9,4601,1665,3207,1394,0,0,6266,,0,1315,1762,1524,4601
28-03-2021,Lakshadweep,6333,200,2,4653,1680,3231,1421,1,0,6333,,0,1321,1795,1537,4653
29-03-2021,Lakshadweep,6333,900,9,4653,1680,3231,1421,1,0,6333,,0,1321,1795,1537,4653
30-03-2021,Lakshadweep,6552,1000,10,4804,1748,3347,1456,1,0,6552,,0,1342,1866,1596,4804
31-03-2021,Lakshadweep,6824,1000,10,5034,1790,3479,1554,1,0,6824,,0,1370,1958,1706,5034
01-04-2021,Lakshadweep,6953,1300,12,5156,1797,3545,1610,1,0,6953,,0,1375,2024,1757,5156
02-04-2021,Lakshadweep,7168,1200,12,5365,1803,3670,1694,1,0,7168,,0,1380,2161,1824,5365
03-04-2021,Lakshadweep,7399,1200,11,5578,1821,3774,1803,1,0,7399,,0,1384,2310,1884,5578
04-04-2021,Lakshadweep,7746,1000,10,5912,1834,3942,1969,1,0,7746,,0,1396,2549,1967,5912
05-04-2021,Lakshadweep,7993,1100,11,6130,1863,4084,2045,1,0,7993,,0,1398,2706,2026,6130
06-04-2021,Lakshadweep,8434,1100,10,6501,1933,4285,2215,1,0,8434,,0,1398,2989,2114,6501
07-04-2021,Lakshadweep,9484,1100,11,7379,2105,4730,2648,1,0,9484,,0,1406,3611,2362,7379
08-04-2021,Lakshadweep,10621,1200,12,8312,2309,5272,3039,1,0,10621,,0,1418,4252,2641,8312
09-04-2021,Lakshadweep,11527,1100,11,9063,2464,5685,3376,2,0,11527,,0,1423,4794,2845,9063
10-04-2021,Lakshadweep,12707,1500,13,10150,2557,6282,3866,2,0,12707,,0,1428,5545,3176,10150
11-04-2021,Lakshadweep,13223,1300,12,10630,2593,6541,4087,2,0,13223,,0,1431,5895,3303,10630
12-04-2021,Lakshadweep,13791,1100,11,11139,2652,6782,4355,2,0,13791,,0,1436,6233,3469,11139
13-04-2021,Lakshadweep,14389,1100,11,11691,2698,7060,4629,2,0,14389,,0,1437,6608,3645,11691
14-04-2021,Lakshadweep,15275,1000,10,12470,2805,7480,4987,3,0,15275,,0,1439,7152,3878,12470
15-04-2021,Lakshadweep,16053,1100,11,13174,2879,7886,5284,4,0,16053,,0,1446,7638,4089,13174
16-04-2021,Lakshadweep,16446,1200,12,13529,2917,8065,5460,4,0,16446,,0,1463,7891,4174,13529
17-04-2021,Lakshadweep,17145,1400,14,14161,2984,8378,5780,3,0,17145,,0,1480,8315,4365,14161
18-04-2021,Lakshadweep,18013,1000,10,14933,3080,8717,6213,3,0,18013,,0,1510,8826,4596,14933
19-04-2021,Lakshadweep,18439,1000,10,15300,3139,8926,6371,3,0,18439,,0,1517,9065,4717,15300
20-04-2021,Lakshadweep,18894,1000,10,15609,3285,9090,6516,3,0,18894,,0,1537,9272,4799,15609
21-04-2021,Lakshadweep,19750,1100,11,16225,3525,9395,6827,3,0,19750,,0,1561,9594,5069,16225
22-04-2021,Lakshadweep,20140,1100,11,16523,3617,9541,6979,3,0,20140,,0,1568,9762,5192,16523
23-04-2021,Lakshadweep,20544,1000,10,16836,3708,9689,7144,3,0,20544,,0,1606,9935,5294,16836
24-04-2021,Lakshadweep,21022,1100,11,17253,3769,9874,7376,3,0,21022,,0,1624,10207,5421,17253
25-04-2021,Lakshadweep,21363,1300,12,17538,3825,10016,7519,3,0,21363,,0,1657,10366,5514,17538
26-04-2021,Lakshadweep,21732,1000,10,17843,3889,10162,7678,3,0,21732,,0,1683,10553,5606,17843
27-04-2021,Lakshadweep,21928,1200,12,17998,3930,10217,7779,2,0,21928,,0,2210,10128,5660,17998
28-04-2021,Lakshadweep,22090,1600,15,18120,3970,10269,7849,2,0,22090,,0,2222,10198,5700,18120
29-04-2021,Lakshadweep,22410,1200,11,18386,4024,10394,7990,2,0,22410,,0,2253,10342,5791,18386
30-04-2021,Lakshadweep,23024,1300,12,18888,4136,10639,8247,2,0,23024,,0,2305,10621,5962,18888
01-05-2021,Lakshadweep,23444,2500,14,19170,4274,10763,8405,2,0,23444,,0,2317,10770,6083,19170
02-05-2021,Lakshadweep,23634,2000,15,19319,4315,10829,8488,2,0,23634,,0,2332,10846,6141,19319
03-05-2021,Lakshadweep,23908,2200,12,19460,4448,10891,8567,2,0,23908,,0,2349,10915,6196,19460
04-05-2021,Lakshadweep,24226,1900,14,19666,4560,10988,8676,2,0,24226,,0,2370,11008,6288,19666
05-05-2021,Lakshadweep,24766,2500,17,19872,4894,11096,8774,2,0,24766,,0,2381,11133,6358,19872
06-05-2021,Lakshadweep,25040,1900,14,19986,5054,11167,8817,2,0,25040,,0,2399,11201,6386,19986
07-05-2021,Lakshadweep,25396,2300,16,20131,5265,11251,8878,2,0,25396,,0,2421,11269,6441,20131
08-05-2021,Lakshadweep,25693,12600,18,20240,5453,11315,8923,2,0,25693,,0,2424,11347,6469,20240
09-05-2021,Lakshadweep,25943,6500,14,20307,5636,11364,8941,2,0,25943,,0,2439,11382,6486,20307
10-05-2021,Lakshadweep,26489,2200,15,20513,5976,11462,9049,2,0,26489,,0,2444,11499,6570,20513
11-05-2021,Lakshadweep,27372,2500,15,20885,6487,11673,9210,2,0,27372,,0,2507,11709,6669,20885
12-05-2021,Lakshadweep,28102,2000,14,21348,6754,11939,9407,2,0,28102,,0,2547,11967,6834,21348
13-05-2021,Lakshadweep,28229,1400,13,21428,6801,11983,9443,2,0,28229,,0,2560,12015,6853,21428
14-05-2021,Lakshadweep,28241,2900,17,21440,6801,11989,9449,2,0,28241,,0,2560,12020,6860,21440
15-05-2021,Lakshadweep,28258,1956,17,21452,6806,11997,9453,2,0,28258,,0,2561,12028,6863,21452
16-05-2021,Lakshadweep,28282,1470,12,21472,6810,12012,9458,2,0,28282,,0,2577,12032,6863,21472
17-05-2021,Lakshadweep,28390,1055,13,21562,6828,12083,9477,2,0,28390,,0,2610,12076,6876,21562
18-05-2021,Lakshadweep,28703,1846,15,21866,6837,12251,9613,2,0,28703,,0,2676,12206,6984,21866
19-05-2021,Lakshadweep,28943,1218,12,22086,6857,12374,9710,2,0,28943,,0,2707,12339,7040,22086
20-05-2021,Lakshadweep,29039,1300,12,22167,6872,12417,9748,2,0,29039,,0,2724,12371,7072,22167
21-05-2021,Lakshadweep,29532,4010,15,22620,6912,12726,9892,2,0,29532,0,0,3131,12407,7082,22620
22-05-2021,Lakshadweep,30027,5659,19,23106,6921,12984,10120,2,0,30027,0,0,3581,12432,7093,23106
23-05-2021,Lakshadweep,30955,3304,19,24029,6926,13472,10555,2,0,30955,0,0,4429,12489,7111,24029
24-05-2021,Lakshadweep,31277,2346,12,24344,6933,13653,10689,2,0,31277,0,0,4636,12568,7140,24344
25-05-2021,Lakshadweep,31319,1949,15,24384,6935,13674,10708,2,0,31319,0,0,4639,12588,7157,24384
26-05-2021,Lakshadweep,31381,3304,17,24446,6935,13715,10729,2,0,31381,0,0,4666,12603,7177,24446
27-05-2021,Lakshadweep,31425,3124,18,24487,6938,13732,10753,2,0,31425,0,0,4667,12627,7193,24487
28-05-2021,Lakshadweep,31668,8840,17,24727,6941,13880,10845,2,0,31668,0,0,4883,12646,7198,24727
29-05-2021,Lakshadweep,32136,25653,14,25192,6944,14160,11030,2,0,32136,0,0,5328,12664,7200,25192
30-05-2021,Lakshadweep,32818,24260,13,25870,6948,14521,11347,2,0,32818,0,0,5987,12682,7201,25870
31-05-2021,Lakshadweep,33636,23644,14,26687,6949,14936,11749,2,0,33636,0,0,6743,12735,7209,26687
01-06-2021,Lakshadweep,34439,18331,13,27489,6950,15314,12173,2,0,34439,0,0,7504,12759,7226,27489
02-06-2021,Lakshadweep,35167,11700,9,28215,6952,15675,12538,2,0,35167,0,0,8187,12797,7231,28215
03-06-2021,Lakshadweep,36206,10810,9,29251,6955,16191,13058,2,0,36206,0,0,9174,12835,7242,29251
04-06-2021,Lakshadweep,37342,11200,10,30378,6964,16769,13607,2,0,37342,0,0,10243,12878,7257,30378
05-06-2021,Lakshadweep,38294,11550,10,31322,6972,17335,13985,2,0,38294,0,0,11121,12926,7275,31322
06-06-2021,Lakshadweep,39071,13350,9,32096,6975,17712,14382,2,0,39071,0,0,11850,12954,7292,32096
07-06-2021,Lakshadweep,40301,14920,10,33318,6983,18344,14972,2,0,40301,0,0,12985,13026,7307,33318
08-06-2021,Lakshadweep,41455,12700,10,34466,6989,18921,15543,2,0,41455,0,0,14094,13061,7311,34466
09-06-2021,Lakshadweep,42665,11580,10,35632,7033,19497,16133,2,0,42665,0,0,15179,13107,7346,35632
10-06-2021,Lakshadweep,43565,12100,8,36523,7042,19916,16605,2,0,43565,0,0,16008,13155,7360,36523
11-06-2021,Lakshadweep,44754,11370,10,37701,7053,20530,17169,2,0,44754,0,0,17128,13197,7376,37701
12-06-2021,Lakshadweep,46083,10920,10,39006,7077,21174,17830,2,0,46083,0,0,18358,13243,7405,39006
13-06-2021,Lakshadweep,46809,10800,9,39722,7087,21527,18193,2,0,46809,0,0,19049,13261,7412,39722
14-06-2021,Lakshadweep,47816,10370,9,40722,7094,22065,18654,3,0,47816,0,0,20007,13291,7424,40722
15-06-2021,Lakshadweep,48599,10300,9,41486,7113,22473,19010,3,0,48599,0,0,20686,13355,7445,41486
16-06-2021,Lakshadweep,49904,9440,10,42783,7121,23098,19682,3,0,49904,0,0,21931,13394,7458,42783
17-06-2021,Lakshadweep,50334,7110,9,43210,7124,23312,19895,3,0,50334,0,0,22311,13435,7464,43210
18-06-2021,Lakshadweep,50773,7100,9,43642,7131,23547,20092,3,0,50773,0,0,22715,13454,7473,43642
19-06-2021,Lakshadweep,51284,5640,10,44126,7158,23777,20346,3,0,51284,0,0,23139,13494,7493,44126
20-06-2021,Lakshadweep,51507,6520,10,44347,7160,23878,20466,3,0,51507,0,0,23326,13519,7502,44347
21-06-2021,Lakshadweep,52001,13620,9,44826,7175,24101,20722,3,0,52001,0,0,23765,13546,7515,44826
22-06-2021,Lakshadweep,52459,11180,9,45234,7225,24308,20923,3,0,52459,0,0,24133,13578,7523,45234
23-06-2021,Lakshadweep,52829,7320,9,45566,7263,24474,21089,3,0,52829,0,0,24410,13611,7545,45566
24-06-2021,Lakshadweep,53150,7270,9,45834,7316,24608,21223,3,0,53150,0,0,24648,13627,7559,45834
25-06-2021,Lakshadweep,53433,6370,9,46057,7376,29400,24030,3,0,53433,0,0,26624,16815,9994,46057
26-06-2021,Lakshadweep,53736,7570,9,46253,7483,29547,24186,3,0,53736,0,0,26839,16884,10013,46253
27-06-2021,Lakshadweep,53855,6680,9,46340,7515,29627,24225,3,0,53855,0,0,26925,16906,10024,46340
28-06-2021,Lakshadweep,54138,5280,9,46494,7644,29786,24349,3,0,54138,0,1,27065,17014,10059,46494
29-06-2021,Lakshadweep,54662,6170,9,46750,7912,30102,24557,3,0,54662,0,1,27393,17172,10097,46750
30-06-2021,Lakshadweep,54700,6170,9,46779,7921,30124,24573,3,0,54700,0,1,27420,17179,10101,46779
01-07-2021,Lakshadweep,54928,6500,10,46901,8027,30242,24683,3,0,54928,0,2,27540,17260,10128,46901
02-07-2021,Lakshadweep,55294,10320,10,47042,8252,30453,24838,3,0,55294,0,3,27678,17427,10189,47042
03-07-2021,Lakshadweep,55632,9300,10,47084,8548,30654,24975,3,0,55632,0,3,27725,17646,10261,47084
04-07-2021,Lakshadweep,55674,9180,9,47084,8590,30686,24985,3,0,55674,0,3,27745,17666,10263,47084
05-07-2021,Lakshadweep,56206,9180,9,47243,8963,30976,25227,3,0,56206,0,3,27909,17933,10364,47243
06-07-2021,Lakshadweep,56755,9180,9,47468,9287,31263,25489,3,0,56755,0,3,28118,18194,10443,47468
