Updated On,State,TotalDosesAdministered,TotalSessionsConducted,TotalSites ,FirstDoseAdministered,SecondDoseAdministered,Male,Female,Transgender,Covaxin,CoviShield,SputnikV,AEFI,18_45_years,45_60_years,60_+_years,Total_Individuals_Vaccinated
16-03-2021,Maharashtra,2785457,334780,2211,2316957,468500,1267604,1049059,294,100256,2685201,,1983,719923,798647,797374,2316957
17-03-2021,Maharashtra,3729963,464690,3316,3229723,500240,1744987,1484314,422,181565,3548398,,2094,740032,972732,1515883,3229723
18-03-2021,Maharashtra,3933965,393730,2742,3408977,524988,1841970,1566567,440,247217,3686748,,2129,754715,1018705,1634460,3408977
19-03-2021,Maharashtra,4178758,442920,3167,3622709,556049,1957125,1665128,456,313185,3865573,,2149,773937,1076650,1771002,3622709
20-03-2021,Maharashtra,4404844,413781,2831,3815920,588924,2060334,1755107,479,394596,4010248,,2225,794595,1135547,1884634,3815920
21-03-2021,Maharashtra,4440954,45720,348,3847301,593653,2077416,1769401,484,406716,4034238,,2234,799405,1145864,1900882,3847301
22-03-2021,Maharashtra,4682864,564326,3827,4060919,621945,2191844,1868558,517,481938,4200926,,2250,816090,1200795,2042860,4060919
23-03-2021,Maharashtra,4911726,466945,3027,4262362,649364,2300351,1961476,535,550924,4360802,,2263,836965,1259159,2165039,4262362
24-03-2021,Maharashtra,5164217,545325,3729,4494807,669410,2424948,2069291,568,604161,4560056,,2298,858387,1322357,2312836,4494807
25-03-2021,Maharashtra,5386656,505730,3394,4701964,684692,2538168,2163205,591,643432,4743224,,2332,879850,1380823,2440041,4701964
26-03-2021,Maharashtra,5648523,552180,3793,4944116,704407,2668802,2274706,608,678503,4970020,,2368,906832,1452755,2583251,4944116
27-03-2021,Maharashtra,5881573,510650,3458,5163746,717827,2785993,2377123,630,708937,5172636,,2402,934213,1525615,2702623,5163746
28-03-2021,Maharashtra,5902265,179230,1295,5183711,718554,2797355,2385726,630,712396,5189869,,2412,936994,1532670,2712751,5183711
29-03-2021,Maharashtra,5956802,271970,1875,5235606,721196,2825369,2409604,633,719696,5237106,,2419,942490,1550684,2741130,5235606
30-03-2021,Maharashtra,6156334,531190,3729,5421876,734458,2923002,2498222,652,747431,5408903,,2428,959925,1606988,2853643,5421876
31-03-2021,Maharashtra,6370261,588630,4238,5618555,751706,3028628,2589252,675,771814,5598447,,2487,980249,1669118,2967853,5618555
01-04-2021,Maharashtra,6596079,555664,4044,5833743,762336,3143391,2689657,695,797453,5798626,,2516,995152,1799984,3037257,5833743
02-04-2021,Maharashtra,6960404,584960,4021,6182629,777775,3330683,2851204,742,831611,6128793,,2744,1020675,2018888,3141695,6182629
03-04-2021,Maharashtra,7288572,611805,4223,6496037,792535,3498169,2997098,770,854490,6434082,,2878,1042761,2211668,3240222,6496037
04-04-2021,Maharashtra,7647126,525322,3715,6841397,805729,3682530,3158056,811,876863,6770263,,2898,1061755,2432945,3345300,6841397
05-04-2021,Maharashtra,7989165,752060,5159,7167016,822149,3851303,3314856,857,894246,7094919,,2926,1062609,2631984,3471012,7167016
06-04-2021,Maharashtra,8257040,719948,5124,7421245,835795,3983541,3436823,881,906206,7350834,,2949,1063410,2793603,3562808,7421245
07-04-2021,Maharashtra,8856664,748140,5192,7988151,868513,4285845,3701369,937,938502,7918162,,2996,1065562,3158551,3762597,7988151
08-04-2021,Maharashtra,9337790,723318,5242,8434286,903504,4529795,3903507,984,970024,8367766,,3049,1068349,3448181,3916304,8434286
09-04-2021,Maharashtra,9632399,695890,4940,8702273,930126,4678646,4022623,1004,1000843,8631556,,3102,1073531,3623531,4003754,8702273
10-04-2021,Maharashtra,9923253,626527,4275,8969876,953377,4827326,4141511,1039,1025624,8897629,,3147,1080036,3802776,4085605,8969876
11-04-2021,Maharashtra,10191896,641340,4292,9220161,971735,4961415,4257679,1067,1043756,9148140,,3160,1084033,3967351,4167310,9220161
12-04-2021,Maharashtra,10528419,722595,4880,9519815,1008604,5124361,4394334,1120,1075618,9452801,,3192,1093721,4158340,4266277,9519815
13-04-2021,Maharashtra,10753451,788245,5532,9717561,1035890,5236582,4479847,1132,1086699,9666752,,3227,1100154,4289501,4326428,9717561
14-04-2021,Maharashtra,11124975,834266,5854,10038913,1086062,5403569,4634179,1165,1103553,10021422,,3241,1109720,4491037,4436667,10038913
15-04-2021,Maharashtra,11511023,852755,6005,10356338,1154685,5576754,4778365,1219,1129851,10381172,,3260,1123832,4689618,4541385,10356338
16-04-2021,Maharashtra,11885830,850505,5884,10658902,1226928,5741917,4915732,1253,1161603,10724227,,3309,1141345,4879200,4636849,10658902
17-04-2021,Maharashtra,12138971,728045,4921,10849828,1289143,5848545,4999988,1295,1206905,10932066,,3336,1155609,4999875,4692813,10849828
18-04-2021,Maharashtra,12273763,778701,5168,10959390,1314373,5908230,5049845,1315,1225133,11048630,,3337,1161937,5069990,4725927,10959390
19-04-2021,Maharashtra,12649330,870145,5816,11240031,1409299,6062034,5176641,1356,1305411,11343919,,3372,1179466,5240194,4818832,11240031
20-04-2021,Maharashtra,12944719,899635,6078,11447258,1497461,6177116,5268751,1391,1401015,11543704,,3392,1194154,5366572,4884992,11447258
21-04-2021,Maharashtra,13279389,878010,5917,11691829,1587560,6306172,5384230,1427,1457704,11821685,,3438,1208118,5515913,4966246,11691829
22-04-2021,Maharashtra,13673833,921785,6287,11966150,1707683,6452197,5512485,1468,1518540,12155293,,3448,1225262,5677988,5061333,11966150
23-04-2021,Maharashtra,13999938,889740,5950,12184886,1815052,6571578,5611811,1497,1568825,12431113,,3518,1244034,5806225,5133050,12184886
24-04-2021,Maharashtra,14229977,757640,4899,12326873,1903104,6647519,5677836,1518,1611245,12618732,,3551,1255990,5894157,5175143,12326873
25-04-2021,Maharashtra,14342185,639205,3985,12404273,1937912,6687026,5715713,1534,1622286,12719899,,3552,1260346,5941954,5200390,12404273
26-04-2021,Maharashtra,14905825,912735,6173,12768316,2137509,6877612,5889111,1593,1656856,13248969,,3604,1283174,6152803,5330744,12768316
27-04-2021,Maharashtra,15321730,904295,6071,13030894,2290836,7016228,6013031,1635,1701178,13620552,,3624,1696717,5912684,5419895,13030894
28-04-2021,Maharashtra,15577636,805874,5364,13184469,2393167,7096557,6086252,1660,1752353,13825283,,3647,1712396,5999532,5470937,13184469
29-04-2021,Maharashtra,15870448,814655,5280,13360080,2510368,7186686,6171712,1682,1791689,14078759,,3671,1731181,6100693,5526938,13360080
30-04-2021,Maharashtra,16183847,822120,5577,13561437,2622410,7294154,6265566,1717,1811340,14372507,,3686,1754101,6211193,5594818,13561437
01-05-2021,Maharashtra,16292753,718001,4803,13637082,2655671,7336072,6299281,1729,1819842,14472911,,3690,1774598,6245315,5615842,13637082
02-05-2021,Maharashtra,16342814,571836,3628,13677591,2665223,7360208,6315650,1733,1822158,14520656,,3697,1796485,6260563,5619437,13677591
03-05-2021,Maharashtra,16425887,723175,4789,13739753,2686134,7396138,6341872,1743,1831851,14594036,,3715,1834683,6275584,5628380,13739753
04-05-2021,Maharashtra,16528345,551024,4017,13799328,2729017,7430828,6366715,1785,1842007,14686338,,3727,1876322,6286649,5635218,13799328
05-05-2021,Maharashtra,16802255,768963,4991,13935541,2866714,7504642,6429098,1801,1857429,14944826,,3752,1929429,6337875,5667095,13935541
06-05-2021,Maharashtra,17296109,852825,5602,14214775,3081334,7656559,6556365,1851,1894014,15402095,,3760,2015005,6451723,5746890,14214775
07-05-2021,Maharashtra,17693374,739171,5067,14458039,3235335,7791637,6664529,1873,1957794,15735580,,3771,2128000,6532388,5796491,14458039
08-05-2021,Maharashtra,17947420,591173,4424,14628881,3318539,7886870,6740099,1912,2013967,15933453,,3772,2218689,6583111,5825908,14628881
09-05-2021,Maharashtra,18063345,378640,2880,14712246,3351099,7934067,6776255,1924,2053522,16009823,,3782,2275174,6600462,5835430,14712246
10-05-2021,Maharashtra,18380699,608656,4391,14888694,3492005,8031959,6854785,1950,2120991,16259708,,3787,2365484,6650633,5871071,14888694
11-05-2021,Maharashtra,18793256,644300,4778,15144171,3649085,8170772,6971410,1989,2199776,16593480,,3789,2470100,6736944,5935295,15144171
12-05-2021,Maharashtra,19139375,674263,5048,15322754,3816621,8265495,7055233,2026,2253699,16885676,,3792,2520147,6812496,5987939,15322754
13-05-2021,Maharashtra,19530640,704430,5267,15499282,4031358,8357188,7140036,2058,2285477,17245163,,3817,2547371,6896576,6052831,15499282
14-05-2021,Maharashtra,19703138,629499,4450,15571915,4131223,8395576,7174270,2069,2302406,17400732,,3817,2562763,6931772,6074774,15571915
15-05-2021,Maharashtra,19912961,663785,4666,15706411,4206550,8463005,7241289,2117,2325861,17587100,,3819,2585250,7004222,6114228,15706411
16-05-2021,Maharashtra,19985484,515985,2829,15756833,4228651,8487642,7267066,2125,2349683,17635801,,3825,2592443,7033773,6127867,15756833
17-05-2021,Maharashtra,20090425,794877,4092,15833287,4257138,8526115,7305037,2135,2381821,17708604,,3827,2604135,7076576,6149790,15833287
18-05-2021,Maharashtra,20201111,703775,3744,15923242,4277869,8571082,7350005,2155,2407445,17793666,,3828,2618066,7120101,6182235,15923242
19-05-2021,Maharashtra,20305921,758724,4243,16000236,4305685,8608590,7389480,2166,2436735,17869186,,3833,2630743,7157611,6208969,16000236
20-05-2021,Maharashtra,20469090,832670,4638,16125493,4343597,8670977,7452325,2191,2479039,17990051,,3869,,7220891,6247827,16125493
21-05-2021,Maharashtra,20594537,734259,3982,16228164,4366373,8722125,7503833,2206,2505192,18089345,0,3875,2674194,7277307,6273586,16228164
22-05-2021,Maharashtra,20721982,809570,4294,16334126,4387856,8775064,7556844,2218,2531917,18190065,0,3885,2700509,7331596,6298837,16334126
23-05-2021,Maharashtra,20764364,558124,2648,16372676,4391688,8794429,7576023,2224,2535934,18228430,0,3887,2711486,7349552,6308414,16372676
24-05-2021,Maharashtra,21017944,1041378,5186,16609722,4408222,8913366,7694102,2254,2551290,18466654,0,3895,2755438,7464860,6386069,16609722
25-05-2021,Maharashtra,21218705,956961,4637,16796171,4422534,9008368,7785519,2284,2565187,18653518,0,3906,2801507,7552870,6438307,16796171
26-05-2021,Maharashtra,21357076,878786,4111,16923391,4433685,9074054,7847040,2297,2578310,18778766,0,3913,2847661,7604605,6467507,16923391
27-05-2021,Maharashtra,21646104,1013766,4568,17185317,4460787,9209335,7973652,2330,2607573,19038531,0,3918,2916840,7726661,6538015,17185317
28-05-2021,Maharashtra,21922389,1048783,4377,17435219,4487170,9339168,8093687,2364,2637677,19284712,0,3920,3004771,7831878,6594452,17435219
29-05-2021,Maharashtra,22230988,1041321,4185,17709573,4521415,9485945,8221218,2410,2678634,19552354,0,3931,3108539,7939428,6657096,17709573
30-05-2021,Maharashtra,22319656,563853,1989,17787436,4532220,9527858,8257161,2417,2691236,19628420,0,3931,3154007,7960373,6668322,17787436
31-05-2021,Maharashtra,22586620,976894,4069,18016877,4569743,9651880,8362542,2455,2732312,19854308,0,3952,3254156,8040667,6716914,18016877
01-06-2021,Maharashtra,22850264,942810,3661,18233839,4616425,9771250,8460113,2476,2785405,20064859,0,3961,3364947,8106539,6756872,18233839
02-06-2021,Maharashtra,23077246,908083,3407,18425383,4651863,9877266,8545617,2500,2827279,20249967,0,3964,3479564,8155926,6784126,18425383
03-06-2021,Maharashtra,23302845,937360,3317,18623132,4679713,9988824,8631777,2531,2858281,20444564,0,3966,3602549,8204069,6810254,18623132
04-06-2021,Maharashtra,23687499,1245247,4606,18959397,4728102,10171294,8785443,2660,2901616,20785883,0,3970,3751630,8320220,6880500,18959397
05-06-2021,Maharashtra,24049547,1178249,4169,19278027,4771520,10347927,8927387,2713,2944627,21104916,4,3976,3914131,8419751,6936344,19278027
06-06-2021,Maharashtra,24145432,572555,1665,19360252,4785180,10392910,8964619,2723,2954409,21190978,45,3976,3974009,8434398,6943523,19360252
07-06-2021,Maharashtra,24450364,1105629,4274,19597498,4852866,10524604,9070141,2753,3012896,21437286,182,3992,4099403,8506028,6982959,19597498
08-06-2021,Maharashtra,24728789,1092184,4096,19794750,4934039,10636491,9155468,2791,3085680,21642671,438,4009,4212977,8560747,7011354,19794750
09-06-2021,Maharashtra,25042464,1187281,4524,20032402,5010062,10767684,9261886,2832,3146790,21895016,658,4015,4333927,8634002,7054147,20032402
10-06-2021,Maharashtra,25300779,1091542,4049,20232933,5067846,10880787,9349279,2867,3194349,22105663,767,4027,4447188,8689485,7085235,20232933
11-06-2021,Maharashtra,25560781,1076281,3781,20443246,5117535,11001538,9438807,2901,3234896,22325051,834,4035,4578917,8740038,7112719,20443246
12-06-2021,Maharashtra,25866677,1189512,4109,20693716,5172961,11142103,9548680,2933,3278833,22587010,834,4038,4725273,8805778,7150441,20693716
13-06-2021,Maharashtra,25958370,583124,1656,20775032,5183338,11186213,9585869,2950,3286997,22670516,857,4038,4787240,8817809,7157338,20775032
14-06-2021,Maharashtra,26263095,1218982,4748,21027493,5235602,11323396,9701115,2982,3320171,22942067,857,4041,4917316,8893159,7203705,21027493
15-06-2021,Maharashtra,26524389,1097730,4320,21239855,5284534,11440659,9796168,3028,3350188,23173280,921,4042,5035886,8953422,7236745,21239855
16-06-2021,Maharashtra,26774547,1075174,4435,21442311,5332236,11553157,9886094,3060,3375760,23397718,1069,4043,5150176,9009866,7268007,21442311
17-06-2021,Maharashtra,26985938,1017427,4199,21609227,5376711,11647730,9958410,3087,3400783,23584061,1094,4044,5250741,9053512,7290278,21609227
18-06-2021,Maharashtra,27220156,1049923,4079,21802528,5417628,11759445,10039969,3114,3418863,23800166,1127,4045,5378785,9097333,7311107,21802528
19-06-2021,Maharashtra,27616708,1299020,4721,22134489,5482219,11942079,10189222,3188,3436486,24179095,1127,4046,5598106,9168865,7351525,22134489
20-06-2021,Maharashtra,27733974,588752,1625,22244712,5489262,12001847,10239649,3216,3440309,24292538,1127,4046,5692538,9179222,7356559,22244712
21-06-2021,Maharashtra,28128768,1446139,4755,22587693,5541075,12182081,10402247,3365,3455691,24671721,1356,4047,5937492,9241396,7391722,22587693
22-06-2021,Maharashtra,28706375,1789303,5104,23089545,5616830,12450141,10635959,3445,3474634,25230118,1623,4064,6323378,9315136,7433206,23089545
23-06-2021,Maharashtra,29345261,1889526,5328,23663198,5682063,12771536,10888124,3538,3497917,25845346,1998,4071,6808171,9372800,7463596,23663198
24-06-2021,Maharashtra,29788061,1682339,4193,24046509,5741552,13002047,11040872,3590,3521073,26264621,2367,4085,7136663,9408647,7481940,24046509
25-06-2021,Maharashtra,30283190,1778923,4176,24455767,5827423,16425226,13853927,4037,3537780,26742702,2708,4103,8886183,11251081,10145926,24455767
26-06-2021,Maharashtra,31032178,2084954,4903,25046626,5985552,16840104,14187894,4180,3564851,27464117,3210,4119,9404539,11406087,10221552,25046626
27-06-2021,Maharashtra,31158987,816613,1666,25144877,6014110,16910677,14244107,4203,3573585,27581915,3487,4121,9494723,11431594,10232670,25144877
28-06-2021,Maharashtra,31781730,1837448,4798,25598367,6183363,17245322,14531964,4444,3604326,28173736,3668,4139,9887178,11584943,10309609,25598367
29-06-2021,Maharashtra,32178658,1391109,3638,25883793,6294865,17459604,14714525,4529,3652273,28522285,4100,4140,10127799,11690903,10359956,25883793
30-06-2021,Maharashtra,32439568,1168259,2875,26067743,6371825,17605731,14829233,4604,3687793,28747059,4716,4152,10290990,11758582,10389996,26067743
01-07-2021,Maharashtra,32720630,1126461,2857,26252541,6468089,17760740,14955237,4653,3756697,28958219,5714,4162,10452291,11834145,10434194,26252541
02-07-2021,Maharashtra,33109808,1268362,3351,26512487,6597321,17976168,15128927,4713,3823686,29279111,7011,4200,10681485,11941041,10487282,26512487
03-07-2021,Maharashtra,33928829,2183238,5205,27072332,6856497,18423363,15500592,4874,3939003,29981854,7972,4215,11164670,12162906,10601253,27072332
04-07-2021,Maharashtra,34076028,907216,1721,27181244,6894784,18502047,15569080,4901,3972341,30095646,8041,4222,11259215,12198730,10618083,27181244
05-07-2021,Maharashtra,34404490,1338724,3308,27418175,6986315,18677942,15721570,4978,4070743,30324716,9031,4222,11455359,12286007,10663124,27418175
06-07-2021,Maharashtra,34802542,1218325,3135,27659911,7142631,18892329,15905165,5048,4152619,30639749,10174,4285,11666727,12409823,10725992,27659911
