Updated On,State,TotalDosesAdministered,TotalSessionsConducted,TotalSites ,FirstDoseAdministered,SecondDoseAdministered,Male,Female,Transgender,Covaxin,CoviShield,SputnikV,AEFI,18_45_years,45_60_years,60_+_years,Total_Individuals_Vaccinated
16-03-2021,Meghalaya,75591,17050,166,61441,14150,35116,26319,6,0,75591,,218,30323,21472,9626,61441
17-03-2021,Meghalaya,79544,15350,141,63623,15921,36280,27337,6,0,79544,,219,30694,22189,10720,63623
18-03-2021,Meghalaya,83678,18600,177,65544,18134,37342,28196,6,0,83678,,219,31073,22909,11542,65544
19-03-2021,Meghalaya,87664,14600,137,67370,20294,38351,29013,6,0,87664,,219,31516,23579,12255,67370
20-03-2021,Meghalaya,89583,8700,82,68157,21426,38852,29298,7,0,89583,,219,31755,23855,12527,68157
21-03-2021,Meghalaya,89631,0,0,68189,21442,38864,29318,7,0,89631,,220,31761,23865,12543,68189
22-03-2021,Meghalaya,93369,16250,161,69870,23499,39726,30137,7,0,93369,,220,32165,24388,13298,69870
23-03-2021,Meghalaya,97710,17550,171,71810,25900,40564,31239,7,0,97710,,221,32446,24991,14352,71810
24-03-2021,Meghalaya,100271,13800,137,73095,27176,41113,31975,7,0,100271,,221,32562,25449,15063,73095
25-03-2021,Meghalaya,104331,19400,191,75260,29071,42127,33126,7,0,104331,,221,32879,26161,16198,75260
26-03-2021,Meghalaya,106715,17000,168,76757,29958,42863,33886,8,0,106715,,221,33100,26702,16933,76757
27-03-2021,Meghalaya,107235,8100,80,77163,30072,43022,34133,8,0,107235,,221,33113,26836,17192,77163
28-03-2021,Meghalaya,107245,7800,72,77173,30072,43029,34136,8,0,107245,,221,33113,26846,17192,77173
29-03-2021,Meghalaya,108601,19250,164,78278,30323,43482,34788,8,0,108601,,221,33208,27240,17808,78278
30-03-2021,Meghalaya,110987,18000,164,79778,31209,44155,35615,8,0,110987,,222,33429,27790,18537,79778
31-03-2021,Meghalaya,112575,16850,153,80790,31785,44606,36176,8,0,112575,,222,33534,28256,18978,80790
01-04-2021,Meghalaya,116161,23280,210,83658,32503,45907,37743,8,0,116161,,222,33711,30141,19784,83658
02-04-2021,Meghalaya,116994,2800,24,84328,32666,46171,38149,8,0,116994,,222,33759,30578,19969,84328
03-04-2021,Meghalaya,118120,9700,90,85243,32877,46604,38631,8,0,118120,,222,33787,31219,20215,85243
04-04-2021,Meghalaya,118451,4300,42,85528,32923,46695,38825,8,0,118451,,222,33775,31429,20302,85528
05-04-2021,Meghalaya,120925,21350,201,87294,33631,47491,39795,8,0,120925,,222,33769,32702,20801,87294
06-04-2021,Meghalaya,122904,22270,206,88683,34221,48089,40586,8,0,122904,,224,33770,33687,21204,88683
07-04-2021,Meghalaya,129112,19950,190,93455,35657,50130,43317,8,0,129112,,227,33845,36913,22675,93455
08-04-2021,Meghalaya,135189,23020,212,98204,36985,52226,45969,9,0,135189,,228,33890,40250,24042,98204
09-04-2021,Meghalaya,139127,19650,187,101170,37957,53553,47608,9,0,139127,,229,33914,42320,24914,101170
10-04-2021,Meghalaya,141326,10100,92,103084,38242,54490,48585,9,0,141326,,229,33936,43691,25435,103084
11-04-2021,Meghalaya,142445,8350,73,104057,38388,54997,49051,9,0,142445,,229,33904,44429,25702,104057
12-04-2021,Meghalaya,146598,21250,190,107560,39038,56737,50814,9,0,146598,,229,33951,46919,26668,107560
13-04-2021,Meghalaya,152825,31150,278,112619,40206,59142,53468,9,0,152825,,229,34131,50331,28135,112619
14-04-2021,Meghalaya,157493,29900,278,116428,41065,60984,55435,9,0,157493,,229,34236,53032,29138,116428
15-04-2021,Meghalaya,163242,33900,282,120703,42539,62871,57821,11,0,163242,,229,34429,55765,30487,120703
16-04-2021,Meghalaya,167533,26150,220,124078,43455,64352,59715,11,0,167533,,230,34490,58115,31451,124078
17-04-2021,Meghalaya,169475,11550,101,125525,43950,64971,60542,12,0,169475,,230,34523,59140,31839,125525
18-04-2021,Meghalaya,169578,9200,91,125611,43967,65012,60587,12,0,169578,,230,34515,59205,31868,125611
19-04-2021,Meghalaya,174722,27000,256,129164,45558,66540,62612,12,0,174722,,230,34620,61631,32890,129164
20-04-2021,Meghalaya,180648,29000,260,133716,46932,68644,65059,13,0,180648,,233,34771,64760,34162,133716
21-04-2021,Meghalaya,185229,28000,259,137342,47887,70343,66986,13,0,185229,,233,34962,67174,35183,137342
22-04-2021,Meghalaya,194508,37050,316,144721,49787,73803,70905,13,0,194508,,233,35458,72123,37115,144721
23-04-2021,Meghalaya,203223,35250,279,151994,51229,77501,74479,14,0,203223,,233,36111,76988,38869,151994
24-04-2021,Meghalaya,209522,35430,212,157665,51857,80233,77418,14,0,209522,,236,36417,80918,40304,157665
25-04-2021,Meghalaya,210172,6100,48,158278,51894,80637,77627,14,0,210172,,236,36483,81377,40392,158278
26-04-2021,Meghalaya,225338,57600,421,171659,53679,87275,84369,15,0,225338,,236,37463,90375,43792,171659
27-04-2021,Meghalaya,242572,69390,493,187409,55163,94885,92508,16,0,242572,,237,47192,92501,47685,187409
28-04-2021,Meghalaya,258617,63630,488,201997,56620,102175,99805,17,0,258617,,240,48909,101786,51271,201997
29-04-2021,Meghalaya,275009,64250,467,216622,58387,109466,107139,17,0,275009,,244,50836,110894,54866,216622
30-04-2021,Meghalaya,290380,59450,464,230464,59916,116434,114013,17,0,290380,,244,53058,119347,58028,230464
01-05-2021,Meghalaya,298016,34600,293,237480,60536,120067,117396,17,0,298016,,245,54736,123328,59385,237480
02-05-2021,Meghalaya,298411,4700,46,237840,60571,120255,117568,17,0,298411,,245,54837,123549,59428,237840
03-05-2021,Meghalaya,307452,41950,369,245544,61908,124170,121356,18,0,307452,,249,56554,128043,60921,245544
04-05-2021,Meghalaya,314897,39620,340,251797,63100,127598,124181,18,0,314897,,252,58413,131302,62056,251797
05-05-2021,Meghalaya,321391,30400,285,257079,64312,130555,126506,18,0,321391,,255,59978,134177,62898,257079
06-05-2021,Meghalaya,330208,41700,378,264289,65919,134409,129860,20,0,330208,,255,62420,137707,64136,264289
07-05-2021,Meghalaya,338720,38600,354,271522,67198,138438,133064,20,0,338720,,256,65249,140920,65327,271522
08-05-2021,Meghalaya,343288,24600,222,275381,67907,140512,134849,20,0,343288,,257,66455,142869,66031,275381
09-05-2021,Meghalaya,343383,1900,12,275458,67925,140552,134886,20,0,343383,,257,66474,142918,66040,275458
10-05-2021,Meghalaya,354169,48200,398,284513,69656,145265,139226,22,0,354169,,257,69727,147187,67573,284513
11-05-2021,Meghalaya,366010,52500,423,294637,71373,150727,143885,25,0,366010,,260,74078,151484,69048,294637
12-05-2021,Meghalaya,376361,47050,426,304094,72267,155976,148092,26,0,376361,,261,78290,155476,70301,304094
13-05-2021,Meghalaya,386756,47450,414,313442,73314,161060,152356,26,0,386756,,264,82666,159137,71611,313442
14-05-2021,Meghalaya,395450,45252,394,321576,73874,165463,156085,28,0,395450,,264,86753,162119,72676,321576
15-05-2021,Meghalaya,400823,27664,247,326762,74061,168275,158458,29,0,400823,,264,89881,163700,73153,326762
16-05-2021,Meghalaya,403743,5411,49,329682,74061,169748,159904,30,0,403743,,266,92325,164008,73321,329682
17-05-2021,Meghalaya,410381,42598,292,336289,74092,173252,163005,32,0,410381,,267,96302,166067,73892,336289
18-05-2021,Meghalaya,415533,35637,239,341428,74105,175997,165399,32,0,415533,,267,100460,166831,74109,341428
19-05-2021,Meghalaya,419281,26748,204,345160,74121,178052,167075,33,0,419281,,268,103318,167521,74293,345160
20-05-2021,Meghalaya,424013,36628,259,349885,74128,180586,169265,34,0,424013,,269,107050,168257,74550,349885
21-05-2021,Meghalaya,429752,42085,297,355602,74150,183599,171969,34,0,429752,0,269,111068,169579,74927,355602
22-05-2021,Meghalaya,434370,35029,243,360217,74153,185985,174198,34,0,434370,0,269,114695,170310,75183,360217
23-05-2021,Meghalaya,435576,2641,27,361423,74153,186553,174836,34,0,435576,0,269,115830,170366,75196,361423
24-05-2021,Meghalaya,440675,52107,399,366496,74179,189269,177192,35,0,440675,0,269,119667,171346,75452,366496
25-05-2021,Meghalaya,446276,57718,424,372070,74206,192358,179677,35,0,446276,0,269,124133,172253,75653,372070
26-05-2021,Meghalaya,449713,47380,367,375503,74210,194273,181193,37,0,449713,0,269,126803,172824,75844,375503
27-05-2021,Meghalaya,455066,47333,354,380830,74236,197127,183665,38,0,455066,0,269,131008,173702,76088,380830
28-05-2021,Meghalaya,459868,45039,332,385587,74281,199811,185736,40,0,459868,0,270,134747,174492,76315,385587
29-05-2021,Meghalaya,463649,29362,221,389328,74321,201855,187433,40,0,463649,0,270,137795,175014,76486,389328
30-05-2021,Meghalaya,464224,1200,12,389900,74324,202163,187697,40,0,464224,0,270,138093,175203,76571,389900
31-05-2021,Meghalaya,465690,30295,217,391350,74340,203018,188292,40,0,465690,0,270,139056,175585,76676,391350
01-06-2021,Meghalaya,467917,32821,233,393547,74370,204352,189155,40,0,467917,0,270,140780,175974,76760,393547
02-06-2021,Meghalaya,469583,22960,184,395183,74400,205284,189859,40,0,469583,0,270,141716,176509,76925,395183
03-06-2021,Meghalaya,471884,36895,265,397450,74434,206546,190864,40,0,471884,0,270,143341,177010,77066,397450
04-06-2021,Meghalaya,474607,32284,238,400152,74455,208018,192093,41,0,474607,0,270,145336,177540,77243,400152
05-06-2021,Meghalaya,476743,16145,123,402281,74462,209058,193182,41,0,476743,0,270,147061,177857,77330,402281
06-06-2021,Meghalaya,476750,100,1,402288,74462,209065,193182,41,0,476750,0,270,147068,177857,77330,402288
07-06-2021,Meghalaya,478264,25451,196,403761,74503,209974,193746,41,0,478264,0,271,148125,178189,77414,403761
08-06-2021,Meghalaya,479293,28316,209,404762,74531,210606,194115,41,0,479293,0,272,148829,178428,77472,404762
09-06-2021,Meghalaya,480229,19980,149,405629,74600,211142,194446,41,0,480229,0,272,149447,178632,77517,405629
10-06-2021,Meghalaya,482623,35270,230,407975,74648,212469,195463,43,0,482623,0,272,151385,178960,77596,407975
11-06-2021,Meghalaya,492296,35851,248,417634,74662,217353,200235,46,0,492296,0,274,160745,179216,77638,417634
12-06-2021,Meghalaya,501614,23565,145,426926,74688,221952,204927,47,0,501614,0,274,169579,179560,77747,426926
13-06-2021,Meghalaya,503182,2776,25,428483,74699,222818,205618,47,0,503182,0,274,171120,179571,77752,428483
14-06-2021,Meghalaya,516828,51408,282,442099,74729,229742,212307,50,0,516828,0,274,184167,180042,77848,442099
15-06-2021,Meghalaya,530738,54427,289,455958,74780,236990,218916,52,0,530738,0,274,197344,180594,77973,455958
16-06-2021,Meghalaya,544781,59299,321,469951,74830,244340,225557,54,0,544781,0,274,210521,181276,78105,469951
17-06-2021,Meghalaya,562928,77365,367,487996,74932,254016,233923,57,0,562928,0,276,227426,182248,78267,487996
18-06-2021,Meghalaya,578098,66639,334,503100,74998,262199,240841,60,0,578098,0,279,241645,182994,78403,503100
19-06-2021,Meghalaya,589906,37362,196,514835,75071,268747,246026,62,0,589906,0,279,252493,183742,78538,514835
20-06-2021,Meghalaya,590972,2160,4,515897,75075,269376,246460,61,0,590972,0,279,253492,183791,78552,515897
21-06-2021,Meghalaya,604195,94222,375,528959,75236,276562,252327,70,0,604195,0,280,265560,184594,78736,528959
22-06-2021,Meghalaya,617157,112245,398,541746,75411,283271,258401,74,0,617157,0,280,277260,185494,78920,541746
23-06-2021,Meghalaya,629639,115669,458,554067,75572,289761,264230,76,0,629639,0,281,288538,186337,79119,554067
24-06-2021,Meghalaya,641778,118500,416,565784,75994,296081,269625,78,0,641778,0,281,299226,187194,79291,565784
25-06-2021,Meghalaya,655138,117512,397,578927,76211,343981,311077,80,0,655138,0,283,346223,211646,97269,578927
26-06-2021,Meghalaya,663542,74136,252,587037,76505,348956,314503,83,0,663542,0,283,353450,212602,97490,587037
27-06-2021,Meghalaya,664291,4751,19,587769,76522,349392,314816,83,0,664291,0,283,354084,212692,97515,587769
28-06-2021,Meghalaya,678691,129359,421,601229,77462,357327,321278,86,0,678691,0,284,366137,214528,98026,601229
29-06-2021,Meghalaya,690638,138677,410,612010,78628,363973,326577,88,0,690638,0,284,375830,216214,98594,612010
30-06-2021,Meghalaya,699213,128393,410,619732,79481,368905,330219,89,0,699213,0,285,382731,217481,99001,619732
01-07-2021,Meghalaya,712223,137493,425,631279,80944,376037,336095,91,0,712223,0,285,393063,219554,99606,631279
02-07-2021,Meghalaya,724020,146589,400,641366,82654,382585,341343,92,0,724020,0,286,402120,221678,100222,641366
03-07-2021,Meghalaya,733404,89498,237,649906,83498,387724,345586,94,0,733404,0,288,409720,223069,100615,649906
04-07-2021,Meghalaya,734356,5100,16,650477,83879,388228,346034,94,0,734356,0,288,410220,223380,100756,650477
05-07-2021,Meghalaya,747397,136723,399,661498,85899,395258,352044,95,0,747397,0,288,419800,226102,101495,661498
06-07-2021,Meghalaya,763595,157498,442,674827,88768,404003,359496,96,0,763595,0,288,431564,229432,102599,674827
