Updated On,State,TotalDosesAdministered,TotalSessionsConducted,TotalSites ,FirstDoseAdministered,SecondDoseAdministered,Male,Female,Transgender,Covaxin,CoviShield,SputnikV,AEFI,18_45_years,45_60_years,60_+_years,Total_Individuals_Vaccinated
16-03-2021,Punjab,411080,95750,736,338578,72502,218611,119950,17,20515,390565,,86,107826,130106,100469,338578
17-03-2021,Punjab,466103,101510,783,390818,75285,248975,141824,19,27711,438392,,87,111279,142833,136524,390818
18-03-2021,Punjab,496341,114820,888,417939,78402,265178,152740,21,31628,464713,,88,115220,151895,150637,417939
19-03-2021,Punjab,530257,127405,990,448570,81687,283314,165230,26,36231,494026,,88,119674,162414,166284,448570
20-03-2021,Punjab,567812,133075,1026,483574,84238,303395,180150,29,41177,526635,,88,125137,175548,182686,483574
21-03-2021,Punjab,578775,83350,647,494076,84699,309474,184573,29,42780,535995,,88,126664,180175,187032,494076
22-03-2021,Punjab,613264,133108,1058,525293,87971,327294,197967,32,46729,566535,,89,131360,191228,202490,525293
23-03-2021,Punjab,649345,133900,1065,558275,91070,346181,212060,34,51280,598065,,90,136875,204051,217130,558275
24-03-2021,Punjab,681673,133000,1047,588402,93271,363826,224539,37,54469,627204,,90,140916,214508,232756,588402
25-03-2021,Punjab,719040,137320,1097,623062,95978,383660,239360,42,57748,661292,,91,145771,226953,250109,623062
26-03-2021,Punjab,755002,130605,1067,657164,97838,403646,253473,45,60930,694072,,91,150818,241773,264338,657164
27-03-2021,Punjab,802200,141310,1125,702391,99809,428611,273730,50,63722,738478,,91,159033,261369,281740,702391
28-03-2021,Punjab,821912,115675,901,721557,100355,439718,281782,57,64477,757435,,91,162546,270231,288523,721557
29-03-2021,Punjab,842376,130650,1021,741177,101199,450817,290303,57,65127,777249,,91,165472,278346,297099,741177
30-03-2021,Punjab,892969,197150,1496,788634,104335,478084,310488,62,67138,825831,,91,173317,297726,317319,788634
31-03-2021,Punjab,944534,217750,1739,836310,108224,506033,330212,65,68748,875786,,92,181939,318025,336057,836310
01-04-2021,Punjab,1004421,290775,2343,892880,111541,538731,354074,75,70684,933737,,92,191034,346202,355342,892880
02-04-2021,Punjab,1076831,311957,2131,961706,115125,579781,381842,83,72956,1003875,,92,202351,380691,378350,961706
03-04-2021,Punjab,1152514,364832,2292,1033601,118913,622631,410881,89,75058,1077456,,93,214034,417037,402205,1033601
04-04-2021,Punjab,1237974,351380,2181,1116418,121556,670370,445942,106,76834,1161140,,94,221470,462199,432404,1116418
05-04-2021,Punjab,1310252,408680,2626,1184561,125691,708672,475777,112,78049,1232203,,94,222128,499594,462493,1184561
06-04-2021,Punjab,1354171,420950,2750,1226129,128042,731981,494033,115,78889,1275282,,94,222546,522770,480464,1226129
07-04-2021,Punjab,1469287,395455,2774,1334736,134551,792437,542169,130,81609,1387678,,97,223227,582327,528829,1334736
08-04-2021,Punjab,1570863,403296,2845,1430914,139949,844326,586454,134,83179,1487684,,97,223663,634561,572333,1430914
09-04-2021,Punjab,1672525,412700,3029,1526823,145702,897127,629552,144,84878,1587647,,97,225771,687388,613304,1526823
10-04-2021,Punjab,1769540,408751,2949,1618233,151307,945976,672103,154,86894,1682646,,97,228148,737388,652333,1618233
11-04-2021,Punjab,1844914,358350,2716,1690799,154115,984345,706288,166,88519,1756395,,97,229793,777694,682947,1690799
12-04-2021,Punjab,1938682,404550,3136,1776693,161989,1029695,746819,179,90221,1848461,,97,234109,823770,718449,1776693
13-04-2021,Punjab,2002350,393115,3075,1835859,166491,1062116,773554,189,91248,1911102,,97,237242,855233,743014,1835859
14-04-2021,Punjab,2080326,395472,3110,1907408,172918,1099429,807783,196,92673,1987653,,97,240174,892658,774205,1907408
15-04-2021,Punjab,2165009,409005,3192,1981682,183327,1139165,842310,207,94001,2071008,,101,245448,931006,804854,1981682
16-04-2021,Punjab,2261353,403925,3181,2066797,194556,1186042,880538,217,95975,2165378,,102,254078,975330,837006,2066797
17-04-2021,Punjab,2352247,414150,3232,2145690,206557,1229489,915975,226,109919,2242328,,103,263089,1016619,865593,2145690
18-04-2021,Punjab,2418071,426863,3310,2205031,213040,1260945,943855,231,139755,2278316,,103,267139,1048356,889144,2205031
19-04-2021,Punjab,2507520,467821,3684,2279891,227629,1301666,977989,236,170585,2336935,,104,274684,1086067,918747,2279891
20-04-2021,Punjab,2594737,482948,3783,2352465,242272,1341443,1010775,247,200643,2394094,,104,284078,1122502,945493,2352465
21-04-2021,Punjab,2657654,455970,3601,2403286,254368,1368903,1034135,248,222491,2435163,,104,288936,1148970,964988,2403286
22-04-2021,Punjab,2714945,450860,3546,2448621,266324,1393501,1054865,255,247670,2467275,,106,294917,1171969,981341,2448621
23-04-2021,Punjab,2811886,464015,3676,2526188,285698,1436640,1089281,267,260445,2551441,,107,306233,1211804,1007760,2526188
24-04-2021,Punjab,2924267,441050,3607,2616660,307607,1486258,1130127,275,269488,2654779,,108,320147,1258055,1038056,2616660
25-04-2021,Punjab,2995036,399500,3232,2676116,318920,1518263,1157570,283,271972,2723064,,108,327939,1289665,1058111,2676116
26-04-2021,Punjab,3085641,440900,3558,2746637,339004,1557024,1189325,288,276911,2808730,,108,339064,1324873,1082297,2746637
27-04-2021,Punjab,3131430,386250,3130,2779190,352240,1575563,1203337,290,280330,2851100,,109,453769,1232601,1092414,2779190
28-04-2021,Punjab,3211403,407500,3258,2837315,374088,1607946,1229070,299,283563,2927840,,109,468081,1258118,1110703,2837315
29-04-2021,Punjab,3292863,419205,3362,2896032,396831,1640493,1255232,307,286915,3005948,,111,483192,1283733,1128780,2896032
30-04-2021,Punjab,3394080,441977,3459,2968888,425192,1681026,1287553,309,290847,3103233,,113,506704,1314045,1147801,2968888
01-05-2021,Punjab,3465616,389440,3023,3022501,443115,1711978,1310207,316,292589,3173027,,113,523408,1337663,1161092,3022501
02-05-2021,Punjab,3498524,345450,2631,3047712,450812,1725721,1321665,326,293109,3205415,,113,528625,1350963,1167812,3047712
03-05-2021,Punjab,3535078,384950,2890,3073058,462020,1740137,1332593,328,294827,3240251,,114,537082,1361804,1173860,3073058
04-05-2021,Punjab,3556000,360850,2695,3087605,468395,1748766,1338505,334,297197,3258803,,116,542849,1367537,1176902,3087605
05-05-2021,Punjab,3636037,406355,2970,3137052,498985,1777391,1359324,337,298553,3337484,,117,561911,1386884,1187937,3137052
06-05-2021,Punjab,3718025,391550,2913,3189159,528866,1807339,1381468,352,300058,3417967,,118,580862,1408117,1199852,3189159
07-05-2021,Punjab,3790968,388800,2939,3234007,556961,1833606,1400038,363,303178,3487790,,118,600517,1424255,1208907,3234007
08-05-2021,Punjab,3859741,359011,2750,3273867,585874,1856337,1417164,366,307956,3551785,,118,614622,1440735,1218182,3273867
09-05-2021,Punjab,3900797,302450,2468,3298768,602029,1870414,1427983,371,310046,3590751,,118,624306,1450648,1223484,3298768
10-05-2021,Punjab,3981861,349450,2825,3343731,638130,1896537,1446817,377,313158,3668703,,118,643234,1466563,1233564,3343731
11-05-2021,Punjab,4065354,340505,2703,3392970,672384,1925982,1466606,382,315687,3749667,,119,665678,1483037,1243845,3392970
12-05-2021,Punjab,4117718,320102,2657,3430867,686851,1947841,1482643,383,318345,3799373,,119,682391,1496408,1251642,3430867
13-05-2021,Punjab,4157568,308200,2546,3460222,697346,1965219,1494618,385,320410,3837158,,119,695922,1506694,1257171,3460222
14-05-2021,Punjab,4176283,296320,2481,3474171,702112,1973451,1500335,385,323438,3852845,,120,703035,1511297,1259395,3474171
15-05-2021,Punjab,4195166,308670,2566,3488899,706267,1981795,1506709,395,328021,3867145,,120,709288,1516978,1262178,3488899
16-05-2021,Punjab,4200672,274656,2043,3493453,707219,1984253,1508805,395,330025,3870647,,120,711161,1518807,1263028,3493453
17-05-2021,Punjab,4209769,296078,2092,3500885,708884,1988458,1512032,395,332964,3876805,,121,714839,1521248,1264339,3500885
18-05-2021,Punjab,4218012,288409,2043,3506609,711403,1991646,1514567,396,336727,3881285,,121,717286,1523362,1265499,3506609
19-05-2021,Punjab,4239354,338780,2170,3526147,713207,2002202,1523549,396,339390,3899964,,121,724049,1532124,1269506,3526147
20-05-2021,Punjab,4277807,381428,2239,3561644,716163,2020942,1540300,402,344485,3933322,,123,733295,1550016,1277852,3561644
21-05-2021,Punjab,4315486,414795,2264,3594976,720510,2039169,1555401,406,351569,3963917,0,124,744034,1565459,1284993,3594976
22-05-2021,Punjab,4370063,531069,2505,3643648,726415,2065462,1577777,409,360657,4009406,0,125,758771,1588713,1295662,3643648
23-05-2021,Punjab,4395438,424410,2044,3664812,730626,2076812,1587588,412,367046,4028392,0,125,766079,1598187,1300038,3664812
24-05-2021,Punjab,4422709,453409,2095,3686593,736116,2088627,1597551,415,375607,4047102,0,125,773936,1607502,1304641,3686593
25-05-2021,Punjab,4449172,382267,1559,3704760,744412,2098548,1605795,417,387811,4061361,0,125,781737,1614520,1307984,3704760
26-05-2021,Punjab,4481288,393643,1782,3732629,748659,2113057,1619148,424,394549,4086739,0,126,790876,1627120,1314110,3732629
27-05-2021,Punjab,4505298,318765,1313,3752636,752662,2123912,1628297,427,400939,4104359,0,126,799914,1634409,1317788,3752636
28-05-2021,Punjab,4524754,291021,1129,3768211,756543,2132446,1635335,430,408056,4116698,0,126,808807,1638825,1320049,3768211
29-05-2021,Punjab,4568745,342869,1243,3807020,761725,2153546,1653040,434,416298,4152447,0,126,824794,1654350,1327342,3807020
30-05-2021,Punjab,4602591,281477,1040,3837481,765110,2169514,1667528,439,422617,4179974,0,126,836417,1666768,1333750,3837481
31-05-2021,Punjab,4639262,362885,1271,3868801,770461,2186630,1681730,441,430555,4208707,0,127,851428,1677560,1339262,3868801
01-06-2021,Punjab,4675210,404347,1235,3899387,775823,2203403,1695541,443,440944,4234266,0,128,866644,1687719,1344468,3899387
02-06-2021,Punjab,4712161,418457,1259,3932229,779932,2221976,1709805,448,447873,4264288,0,129,883726,1698155,1349787,3932229
03-06-2021,Punjab,4749239,390672,1184,3965188,784051,2240355,1724382,451,455088,4294151,0,131,902162,1707769,1354687,3965188
04-06-2021,Punjab,4809245,497102,1710,4020410,788835,2271265,1748674,471,461592,4347653,0,131,929538,1725701,1364585,4020410
05-06-2021,Punjab,4872289,482875,1680,4079301,792988,2304398,1774426,477,467168,4405121,0,132,959135,1744707,1374862,4079301
06-06-2021,Punjab,4911988,359050,1113,4117141,794847,2325212,1791444,485,469698,4442290,0,132,981447,1754891,1380195,4117141
07-06-2021,Punjab,4962200,475585,1608,4163128,799072,2350961,1811676,491,474525,4487675,0,132,1007310,1767664,1387537,4163128
08-06-2021,Punjab,5010368,451478,1473,4207220,803148,2376346,1830375,499,479333,4531035,0,132,1035158,1778015,1393424,4207220
09-06-2021,Punjab,5041984,424695,1316,4236020,805964,2393181,1842334,505,484407,4557577,0,132,1054404,1784135,1396852,4236020
10-06-2021,Punjab,5070549,437449,1178,4261364,809185,2408391,1852467,506,492339,4578210,0,132,1071020,1789720,1399991,4261364
11-06-2021,Punjab,5123208,572435,1761,4309836,813372,2436314,1873003,519,497719,4625489,0,132,1102603,1800582,1406015,4309836
12-06-2021,Punjab,5187108,565348,1804,4370081,817027,2469449,1900102,530,501565,4685543,0,132,1139279,1815929,1414232,4370081
13-06-2021,Punjab,5219611,436384,1224,4400382,819229,2485605,1914246,531,504443,4715168,0,132,1154757,1825985,1418996,4400382
14-06-2021,Punjab,5246782,443056,1325,4424663,822119,2498687,1925443,533,507219,4739563,0,132,1167485,1833574,1422957,4424663
15-06-2021,Punjab,5277700,485262,1471,4450734,826966,2512775,1937422,537,511778,4765922,0,132,1180304,1842017,1427762,4450734
16-06-2021,Punjab,5299801,473336,1370,4468606,831195,2521817,1946245,544,514920,4784881,0,132,1187773,1848693,1431486,4468606
17-06-2021,Punjab,5327778,538222,1418,4490513,837265,2532908,1957060,545,518798,4808980,0,132,1196099,1857565,1436189,4490513
18-06-2021,Punjab,5356568,524827,1413,4513149,843419,2544344,1968254,551,522960,4833608,0,132,1204663,1866625,1441194,4513149
19-06-2021,Punjab,5385524,514172,1342,4535431,850093,2555779,1979098,554,527628,4857896,0,133,1212882,1875887,1445992,4535431
20-06-2021,Punjab,5422887,597208,1142,4565935,856952,2571915,1993461,559,532348,4890539,0,133,1222733,1889813,1452715,4565935
21-06-2021,Punjab,5521994,1413779,2020,4654728,867266,2620254,2033900,574,543657,4978312,25,133,1288490,1904566,1460959,4654728
22-06-2021,Punjab,5647031,1618940,2137,4764482,882549,2678713,2085182,587,559784,5087087,160,133,1370578,1922557,1470605,4764482
23-06-2021,Punjab,5736250,1482614,1854,4839891,896359,2719753,2119541,597,573956,5162089,205,134,1425741,1935606,1477776,4839891
24-06-2021,Punjab,5844271,1576846,1889,4929959,914312,2768709,2160646,604,586937,5257129,205,135,1491039,1951648,1486481,4929959
25-06-2021,Punjab,5972116,1907289,2234,5036271,935845,3386593,2584863,660,605642,5366112,362,137,1805411,2308869,1857836,5036271
26-06-2021,Punjab,6114078,2016722,2177,5146916,967162,3463796,2649607,675,625978,5487549,551,160,1897965,2339883,1876230,5146916
27-06-2021,Punjab,6182574,1337277,1278,5204384,978190,3501086,2680806,682,652286,5529737,551,163,1942037,2355291,1885246,5204384
28-06-2021,Punjab,6230597,1452738,1333,5242562,988035,3526399,2703515,683,671687,5558149,761,165,1972507,2366050,1892040,5242562
29-06-2021,Punjab,6265875,1102784,1009,5269832,996043,3544983,2720205,687,689902,5574983,990,166,1994913,2374032,1896930,5269832
30-06-2021,Punjab,6292478,847532,841,5289807,1002671,3559003,2732784,691,705149,5586174,1155,166,2012022,2379987,1900469,5289807
01-07-2021,Punjab,6314228,475348,619,5307013,1007215,3570119,2743415,694,719137,5593767,1324,168,2025812,2384789,1903627,5307013
02-07-2021,Punjab,6346355,805792,884,5327984,1018371,3587377,2758279,699,731489,5613353,1513,170,2043502,2393584,1909269,5327984
03-07-2021,Punjab,6894264,3730453,3180,5710932,1183332,3877857,3015650,757,754339,6138212,1713,172,2336467,2547116,2010681,5710932
04-07-2021,Punjab,7017721,1279001,1224,5800293,1217428,3943658,3073297,766,772345,6243663,1713,174,2403507,2582077,2032137,5800293
05-07-2021,Punjab,7070442,1065384,1075,5835504,1234938,3972017,3097655,770,786825,6281904,1713,174,2432723,2596270,2041449,5835504
06-07-2021,Punjab,7095644,677289,742,5853013,1242631,3985321,3109548,775,798339,6295572,1733,178,2447762,2602571,2045311,5853013
