Updated On,State,TotalDosesAdministered,TotalSessionsConducted,TotalSites ,FirstDoseAdministered,SecondDoseAdministered,Male,Female,Transgender,Covaxin,CoviShield,SputnikV,AEFI,18_45_years,45_60_years,60_+_years,Total_Individuals_Vaccinated
16-03-2021,Sikkim,50954,4880,24,42816,8138,24070,18741,5,0,50954,,177,14771,10291,17744,42816
17-03-2021,Sikkim,54631,7400,41,46124,8507,25843,20276,5,0,54631,,182,14936,10988,20190,46124
18-03-2021,Sikkim,57312,7110,39,48290,9022,26911,21374,5,0,57312,,184,15049,11515,21716,48290
19-03-2021,Sikkim,59889,5210,28,50370,9519,27973,22392,5,0,59889,,185,15146,12090,23123,50370
20-03-2021,Sikkim,61649,3850,21,51788,9861,28737,23046,5,0,61649,,185,15218,12395,24164,51788
21-03-2021,Sikkim,61716,0,0,51854,9862,28778,23071,5,0,61716,,185,15216,12408,24219,51854
22-03-2021,Sikkim,64495,5200,28,53523,10972,29656,23862,5,0,64495,,187,15323,12774,25414,53523
23-03-2021,Sikkim,67281,5550,31,55534,11747,30675,24854,5,0,67281,,187,15419,13174,26929,55534
24-03-2021,Sikkim,69288,4800,29,57257,12031,31566,25686,5,0,69288,,189,15567,13545,28133,57257
25-03-2021,Sikkim,71024,5250,29,58846,12178,32379,26461,6,0,71024,,190,15669,13940,29224,58846
26-03-2021,Sikkim,72788,5250,28,60509,12279,33221,27282,6,0,72788,,190,15790,14440,30266,60509
27-03-2021,Sikkim,72814,500,3,60535,12279,33236,27293,6,0,72814,,190,15785,14460,30277,60535
28-03-2021,Sikkim,72815,1050,5,60536,12279,33237,27293,6,0,72815,,191,15785,14460,30278,60536
29-03-2021,Sikkim,72815,950,6,60536,12279,33237,27293,6,0,72815,,192,15785,14460,30278,60536
30-03-2021,Sikkim,73752,3420,21,61317,12435,33654,27657,6,0,73752,,192,15845,14646,30813,61317
31-03-2021,Sikkim,74191,4600,21,61697,12494,33864,27827,6,0,74191,,192,15887,14757,31040,61697
01-04-2021,Sikkim,77314,6890,36,64678,12636,35319,29352,7,0,77314,,194,15918,17303,31443,64678
02-04-2021,Sikkim,78293,1200,4,65631,12662,35798,29826,7,0,78293,,195,15922,18133,31562,65631
03-04-2021,Sikkim,78880,1700,9,66218,12662,36108,30103,7,0,78880,,195,15908,18653,31643,66218
04-04-2021,Sikkim,79192,800,3,66530,12662,36263,30260,7,0,79192,,195,15901,18956,31659,66530
05-04-2021,Sikkim,82059,6990,38,69217,12842,37475,31734,8,0,82059,,195,15779,21239,32185,69217
06-04-2021,Sikkim,85747,9450,54,72723,13024,39241,33474,8,0,85747,,196,15761,24257,32690,72723
07-04-2021,Sikkim,94426,10270,55,80892,13534,43424,37458,10,0,94426,,198,15636,31228,34013,80892
08-04-2021,Sikkim,104473,12950,72,90081,14392,48224,41846,11,0,104473,,198,15613,38882,35571,90081
09-04-2021,Sikkim,112414,11950,68,97386,15028,52111,45263,12,0,112414,,200,15598,45008,36765,97386
10-04-2021,Sikkim,115201,8100,40,99963,15238,53501,46450,12,0,115201,,201,15609,47139,37200,99963
11-04-2021,Sikkim,117171,5880,28,101795,15376,54514,47269,12,0,117171,,202,15607,48675,37498,101795
12-04-2021,Sikkim,125831,13380,70,109886,15945,58712,51160,14,0,125831,,205,15719,54937,39215,109886
13-04-2021,Sikkim,135455,12850,72,118962,16493,63554,55393,15,0,135455,,208,15689,62133,41125,118962
14-04-2021,Sikkim,141777,12660,71,124532,17245,66641,57875,16,0,141777,,208,15680,66445,42392,124532
15-04-2021,Sikkim,148555,13810,76,130118,18437,69669,60433,16,0,148555,,208,15776,70727,43600,130118
16-04-2021,Sikkim,155241,13050,75,135490,19751,72614,62859,17,0,155241,,208,15874,74784,44817,135490
17-04-2021,Sikkim,160123,9100,50,139394,20729,74811,64566,17,0,160123,,208,15926,77799,45654,139394
18-04-2021,Sikkim,161058,5750,31,140119,20939,75242,64859,18,0,161058,,208,15927,78345,45832,140119
19-04-2021,Sikkim,166609,12350,67,143952,22657,77319,66615,18,0,166609,,208,16036,81043,46858,143952
20-04-2021,Sikkim,171123,13050,66,146868,24255,78909,67938,21,0,171123,,210,16097,83025,47731,146868
21-04-2021,Sikkim,172465,8350,41,147787,24678,79409,68357,21,0,172465,,211,16127,83722,47923,147787
22-04-2021,Sikkim,177162,13650,74,149886,27276,80504,69361,21,0,177162,,212,16153,85112,48606,149886
23-04-2021,Sikkim,182621,12450,68,152278,30343,81780,70477,21,0,182621,,213,16181,86446,49638,152278
24-04-2021,Sikkim,185449,10400,53,153579,31870,82518,71040,21,0,185449,,214,16237,87240,50089,153579
25-04-2021,Sikkim,185895,4200,21,153939,31956,82716,71202,21,0,185895,,214,16244,87486,50196,153939
26-04-2021,Sikkim,189953,12000,63,155696,34257,83649,72026,21,0,189953,,214,16284,88578,50821,155696
27-04-2021,Sikkim,193834,11380,62,157168,36666,84481,72666,21,0,193834,,215,19796,86030,51329,157168
28-04-2021,Sikkim,196919,10400,56,158440,38479,85196,73223,21,0,196919,,216,19907,86771,51749,158440
29-04-2021,Sikkim,200586,11500,57,159827,40759,85982,73824,21,0,200586,,216,19933,87558,52324,159827
30-04-2021,Sikkim,203966,10900,55,161083,42883,86706,74356,21,0,203966,,217,19974,88292,52804,161083
01-05-2021,Sikkim,204960,4900,28,161364,43596,86858,74485,21,0,204960,,217,19985,88476,52890,161364
02-05-2021,Sikkim,204990,2900,15,161376,43614,86866,74489,21,0,204990,,217,19975,88498,52894,161376
03-05-2021,Sikkim,207754,8500,52,162016,45738,87204,74791,21,0,207754,,217,20022,88803,53182,162016
04-05-2021,Sikkim,210281,8500,56,162666,47615,87549,75096,21,0,210281,,217,20052,89208,53397,162666
05-05-2021,Sikkim,212688,10700,63,163194,49494,87847,75326,21,0,212688,,217,20110,89444,53631,163194
06-05-2021,Sikkim,215456,12050,72,164073,51383,88344,75708,21,0,215456,,217,20176,89974,53914,164073
07-05-2021,Sikkim,218368,11100,68,164598,53770,88646,75931,21,0,218368,,217,20250,90185,54154,164598
08-05-2021,Sikkim,219141,6100,37,164772,54369,88741,76010,21,0,219141,,217,20246,90285,54232,164772
09-05-2021,Sikkim,219312,900,6,164805,54507,88758,76026,21,0,219312,,217,20245,90311,54240,164805
10-05-2021,Sikkim,221248,10000,57,165201,56047,88980,76199,22,0,221248,,217,20332,90489,54370,165201
11-05-2021,Sikkim,222448,9100,55,165440,57008,89096,76322,22,0,222448,,217,20349,90639,54441,165440
12-05-2021,Sikkim,223154,9500,52,165669,57485,89228,76419,22,0,223154,,217,20388,90748,54522,165669
13-05-2021,Sikkim,224984,11100,60,165948,59036,89398,76528,22,0,224984,,217,20459,90900,54577,165948
14-05-2021,Sikkim,225702,9100,54,166119,59583,89488,76609,22,0,225702,,217,20471,91018,54618,166119
15-05-2021,Sikkim,225794,8200,48,166200,59594,89534,76644,22,0,225794,,217,20472,91079,54636,166200
16-05-2021,Sikkim,226156,1870,11,166562,59594,89701,76839,22,0,226156,,217,20823,91086,54640,166562
17-05-2021,Sikkim,226891,9759,56,167276,59615,90080,77174,22,0,226891,,217,21364,91206,54693,167276
18-05-2021,Sikkim,227622,6004,39,168003,59619,90466,77515,22,0,227622,,217,21966,91281,54743,168003
19-05-2021,Sikkim,229107,6391,32,169488,59619,91303,78163,22,0,229107,,217,23184,91460,54831,169488
20-05-2021,Sikkim,230980,8359,49,171357,59623,92359,78976,22,0,230980,,217,24697,91662,54985,171357
21-05-2021,Sikkim,232718,12158,64,173083,59635,93293,79766,24,0,232718,0,217,26139,91832,55099,173083
22-05-2021,Sikkim,234303,5947,32,174666,59637,94145,80496,25,0,234303,0,217,27557,91944,55152,174666
23-05-2021,Sikkim,234303,1900,10,174666,59637,94145,80496,25,0,234303,0,217,27557,91944,55152,174666
24-05-2021,Sikkim,235593,8943,46,175956,59637,94852,81078,26,0,235593,0,217,28697,92041,55205,175956
25-05-2021,Sikkim,236874,10354,55,177233,59641,95576,81631,26,0,236874,0,217,29776,92180,55264,177233
26-05-2021,Sikkim,237959,7243,39,178318,59641,96163,82129,26,0,237959,0,219,30847,92192,55266,178318
27-05-2021,Sikkim,238715,7597,37,179072,59643,96551,82494,27,0,238715,0,219,31509,92267,55283,179072
28-05-2021,Sikkim,238828,8140,38,179180,59648,96612,82541,27,0,238828,0,219,31574,92298,55295,179180
29-05-2021,Sikkim,238891,3364,14,179238,59653,96647,82564,27,0,238891,0,219,31609,92315,55301,179238
30-05-2021,Sikkim,238891,0,0,179238,59653,96647,82564,27,0,238891,0,219,31609,92315,55301,179238
31-05-2021,Sikkim,238983,2260,14,179322,59661,96695,82600,27,0,238983,0,219,31639,92344,55326,179322
01-06-2021,Sikkim,239043,1913,11,179370,59673,96724,82619,27,0,239043,0,219,31663,92355,55339,179370
02-06-2021,Sikkim,239174,2495,16,179483,59691,96766,82690,27,0,239174,0,219,31745,92382,55343,179483
03-06-2021,Sikkim,239355,2340,15,179658,59697,96843,82788,27,0,239355,0,219,31842,92439,55363,179658
04-06-2021,Sikkim,239548,2355,18,179835,59713,96897,82911,27,0,239548,0,219,31970,92473,55378,179835
05-06-2021,Sikkim,239628,1940,11,179914,59714,96905,82982,27,0,239628,0,219,32044,92476,55380,179914
06-06-2021,Sikkim,239779,200,1,180065,59714,96907,83131,27,0,239779,0,219,32195,92476,55380,180065
07-06-2021,Sikkim,240036,2505,17,180310,59726,96981,83302,27,0,240036,0,219,32388,92520,55388,180310
08-06-2021,Sikkim,240711,2616,16,180973,59738,97299,83647,27,0,240711,0,219,32842,92659,55458,180973
09-06-2021,Sikkim,244354,8770,28,184590,59764,99330,85232,28,0,244354,0,219,36283,92781,55509,184590
10-06-2021,Sikkim,252346,15915,57,192568,59778,103898,88636,34,0,252346,0,219,43814,93070,55663,192568
11-06-2021,Sikkim,264968,19522,72,205177,59791,110947,94188,42,0,264968,0,221,56118,93279,55752,205177
12-06-2021,Sikkim,273389,15396,46,213590,59799,115660,97879,51,0,273389,0,221,64371,93384,55796,213590
13-06-2021,Sikkim,273567,350,1,213768,59799,115754,97963,51,0,273567,0,221,64549,93384,55796,213768
14-06-2021,Sikkim,286462,21416,70,226626,59836,122680,103888,58,0,286462,0,221,77086,93614,55870,226626
15-06-2021,Sikkim,302373,23580,71,242535,59838,131506,110967,62,0,302373,0,222,92818,93725,55915,242535
16-06-2021,Sikkim,317335,25154,75,257485,59850,139687,117729,69,0,317335,0,222,107576,93852,55961,257485
17-06-2021,Sikkim,331827,24846,79,271946,59881,147307,124561,78,0,331827,0,225,121783,94008,56026,271946
18-06-2021,Sikkim,347391,28403,89,287492,59899,155746,131662,84,0,347391,0,226,136980,94236,56125,287492
19-06-2021,Sikkim,358633,21991,52,298722,59911,161842,136789,91,0,358633,0,226,148091,94319,56152,298722
20-06-2021,Sikkim,359435,1800,5,299524,59911,162455,136978,91,0,359435,0,226,148893,94319,56152,299524
21-06-2021,Sikkim,371403,27234,70,311460,59943,168528,142827,105,0,371403,0,228,160640,94458,56183,311460
22-06-2021,Sikkim,385331,25489,68,325348,59983,175543,149691,114,0,385331,0,234,174320,94592,56209,325348
23-06-2021,Sikkim,397182,21544,60,337151,60031,181946,155088,117,0,397182,0,235,185716,94884,56305,337151
24-06-2021,Sikkim,409995,21919,57,349190,60805,188333,160732,125,0,409995,0,243,197290,95216,56412,349190
25-06-2021,Sikkim,423563,24674,65,362037,61526,228286,195144,133,0,423563,0,253,226797,110328,86438,362037
26-06-2021,Sikkim,433131,16726,37,371534,61597,233787,199203,141,0,433131,0,260,236169,110488,86474,371534
27-06-2021,Sikkim,433136,707,5,371539,61597,233788,199207,141,0,433136,0,260,236174,110488,86474,371539
28-06-2021,Sikkim,448770,29538,64,384196,64574,241853,206767,150,0,448770,0,265,248502,113348,86920,384196
29-06-2021,Sikkim,462454,30074,63,394505,67949,249158,213144,152,0,462454,0,265,258336,116614,87504,394505
30-06-2021,Sikkim,473810,24535,62,401506,72304,255410,218239,161,0,473810,0,267,264833,120599,88378,401506
01-07-2021,Sikkim,483470,22663,47,407286,76184,260810,222495,165,0,483470,0,272,270383,124072,89015,407286
02-07-2021,Sikkim,493534,23059,50,411724,81810,266270,227099,165,0,493534,0,272,274297,129100,90137,411724
03-07-2021,Sikkim,501578,18392,42,416397,85181,270842,230568,168,0,501578,0,275,278654,132201,90723,416397
04-07-2021,Sikkim,501580,660,4,416397,85183,270843,230569,168,0,501580,0,277,278654,132203,90723,416397
05-07-2021,Sikkim,515248,25446,63,423054,92194,278130,236946,172,0,515248,0,277,284776,138281,92191,423054
06-07-2021,Sikkim,527470,24954,52,428512,98958,285139,242156,175,0,527470,0,279,289548,144231,93691,428512
