Updated On,State,TotalDosesAdministered,TotalSessionsConducted,TotalSites ,FirstDoseAdministered,SecondDoseAdministered,Male,Female,Transgender,Covaxin,CoviShield,SputnikV,AEFI,18_45_years,45_60_years,60_+_years,Total_Individuals_Vaccinated
16-03-2021,Uttarakhand,398546,80120,439,300292,98254,168902,131362,28,0,398546,,236,108420,86666,105080,300292
17-03-2021,Uttarakhand,459272,62850,341,357365,101907,199594,157732,39,0,459272,,237,109421,91883,155928,357365
18-03-2021,Uttarakhand,491749,87320,455,385031,106718,213944,171044,43,0,491749,,237,110941,94726,179230,385031
19-03-2021,Uttarakhand,523715,92560,480,413175,110540,228398,184729,48,0,523715,,239,112640,97745,202655,413175
20-03-2021,Uttarakhand,542470,65950,313,429295,113175,236823,192423,49,0,542470,,241,113870,99997,215288,429295
21-03-2021,Uttarakhand,545854,15850,69,432481,113373,238519,193912,50,0,545854,,242,114177,100629,217531,432481
22-03-2021,Uttarakhand,575163,90950,487,458968,116195,251825,207091,52,0,575163,,243,115105,103210,240508,458968
23-03-2021,Uttarakhand,604131,93200,492,485452,118679,265140,220258,54,0,604131,,246,116178,106183,262939,485452
24-03-2021,Uttarakhand,623127,70600,388,502979,120148,274143,228778,58,0,623127,,246,116836,108226,277763,502979
25-03-2021,Uttarakhand,651083,97050,523,529381,121702,287634,241684,63,0,651083,,247,117672,111100,300454,529381
26-03-2021,Uttarakhand,677407,96650,525,554351,123056,300030,254258,63,0,677407,,249,118479,113895,321815,554351
27-03-2021,Uttarakhand,691740,61700,360,567912,123828,306948,260900,64,355,691385,,249,119145,115813,332791,567912
28-03-2021,Uttarakhand,692153,17030,85,568301,123852,307148,261089,64,355,691798,,249,119171,115913,333054,568301
29-03-2021,Uttarakhand,692153,17762,81,568301,123852,307148,261089,64,355,691798,,249,119171,115913,333054,568301
30-03-2021,Uttarakhand,709629,74710,422,583674,125955,315062,268546,66,355,709274,,249,119811,118218,345478,583674
31-03-2021,Uttarakhand,729248,79690,410,600464,128784,323648,276749,67,355,728893,,249,120637,120657,359002,600464
01-04-2021,Uttarakhand,766976,116670,565,635483,131493,340800,294615,68,407,766569,,249,121523,141452,372336,635483
02-04-2021,Uttarakhand,819787,104950,478,684342,135445,364780,319487,75,407,819380,,250,122857,173771,387541,684342
03-04-2021,Uttarakhand,864109,94900,455,724528,139581,384005,340446,77,407,863702,,254,123971,200392,399992,724528
04-04-2021,Uttarakhand,911431,83300,366,768440,142991,405763,362588,89,407,911024,,256,124753,231235,412279,768440
05-04-2021,Uttarakhand,963846,145120,678,816359,147487,427701,388567,91,407,963439,,260,124858,262203,429126,816359
06-04-2021,Uttarakhand,1010592,154760,724,859144,151448,446923,412126,95,407,1010185,,262,124908,290091,443972,859144
07-04-2021,Uttarakhand,1103202,136340,612,943113,160089,485930,457072,111,407,1102795,,264,125034,346048,471856,943113
08-04-2021,Uttarakhand,1183048,161827,735,1015354,167694,519086,496142,126,407,1182641,,266,125098,393660,496422,1015354
09-04-2021,Uttarakhand,1243903,156622,737,1070092,173811,545031,524925,136,407,1243496,,271,125419,429295,515200,1070092
10-04-2021,Uttarakhand,1284053,122500,517,1105047,179006,561620,543289,138,434,1283619,,272,125540,452743,526586,1105047
11-04-2021,Uttarakhand,1309345,97550,433,1127677,181668,572510,555026,141,434,1308911,,272,125545,468019,533933,1127677
12-04-2021,Uttarakhand,1362476,148660,673,1171473,191003,592678,578641,154,434,1362042,,273,125660,496352,549282,1171473
13-04-2021,Uttarakhand,1403514,156100,712,1205463,198051,609525,595778,160,434,1403080,,273,125827,518112,561345,1205463
14-04-2021,Uttarakhand,1432533,136320,635,1228701,203832,620897,607641,163,434,1432099,,273,125879,533255,569388,1228701
15-04-2021,Uttarakhand,1467119,145370,681,1254070,213049,633240,620661,169,434,1466685,,273,126150,549231,578508,1254070
16-04-2021,Uttarakhand,1519229,155260,723,1291512,227717,651678,639659,175,463,1518766,,274,126432,572501,592386,1291512
17-04-2021,Uttarakhand,1565895,143800,616,1324893,241002,668476,656235,182,463,1565432,,275,127036,593273,604389,1324893
18-04-2021,Uttarakhand,1568659,82150,373,1326852,241807,669402,657268,182,463,1568196,,275,127030,594527,605100,1326852
19-04-2021,Uttarakhand,1628596,158625,774,1367015,261581,689432,677396,187,463,1628133,,276,127572,618654,620593,1367015
20-04-2021,Uttarakhand,1679001,147504,733,1400819,278182,706600,694026,193,463,1678538,,276,128056,638747,633819,1400819
21-04-2021,Uttarakhand,1716299,142350,716,1426757,289542,719428,707129,200,463,1715836,,276,128337,654852,643371,1426757
22-04-2021,Uttarakhand,1767643,150255,789,1461317,306326,735671,725432,214,463,1767180,,276,128813,676508,655801,1461317
23-04-2021,Uttarakhand,1810870,138370,694,1491294,319576,750046,741027,221,516,1810354,,276,129379,695227,666492,1491294
24-04-2021,Uttarakhand,1851547,133860,623,1519001,332546,763711,755065,225,711,1850836,,276,129910,713144,675748,1519001
25-04-2021,Uttarakhand,1868785,117200,544,1531495,337290,769950,761318,227,833,1867952,,276,130141,721194,679959,1531495
26-04-2021,Uttarakhand,1919534,152120,768,1564510,355024,785606,778670,234,1219,1918315,,277,131015,740959,692332,1564510
27-04-2021,Uttarakhand,1953190,130350,681,1587147,366043,796926,789983,238,1639,1951551,,277,166579,720311,700052,1587147
28-04-2021,Uttarakhand,1992077,144750,699,1612469,379608,809722,802504,243,2003,1990074,,279,168089,735564,708608,1612469
29-04-2021,Uttarakhand,2036059,142120,739,1639998,396061,823707,816039,252,2444,2033615,,279,169665,752151,718014,1639998
30-04-2021,Uttarakhand,2079214,129050,680,1665065,414149,836549,828254,262,3102,2076112,,279,171391,767730,725771,1665065
01-05-2021,Uttarakhand,2099055,105850,556,1674974,424081,841834,832878,262,3527,2095528,,280,172569,773684,728548,1674974
02-05-2021,Uttarakhand,2105869,91550,403,1677900,427969,843391,834247,262,3951,2101918,,280,172507,775831,729408,1677900
03-05-2021,Uttarakhand,2117345,123150,601,1683130,434215,846099,836767,264,5133,2112212,,280,172847,779107,731022,1683130
04-05-2021,Uttarakhand,2149462,145640,673,1695482,453980,852698,842519,265,6110,2143352,,280,174458,786313,734557,1695482
05-05-2021,Uttarakhand,2197687,162850,740,1712874,484813,861746,850861,267,6747,2190940,,280,176336,796405,739979,1712874
06-05-2021,Uttarakhand,2256480,174352,818,1734466,522014,872239,861951,276,7324,2249156,,280,177780,809253,747276,1734466
07-05-2021,Uttarakhand,2307663,169611,791,1753256,554407,881802,871175,279,7944,2299719,,282,179253,820395,753451,1753256
08-05-2021,Uttarakhand,2349729,146202,674,1768741,580988,889708,878751,282,8487,2341242,,282,180600,829914,758064,1768741
09-05-2021,Uttarakhand,2373371,109800,481,1777937,595434,894481,883169,287,8879,2364492,,282,181374,835695,760705,1777937
10-05-2021,Uttarakhand,2445484,178512,784,1813356,632128,913963,899095,298,9669,2435815,,282,197679,848163,767290,1813356
11-05-2021,Uttarakhand,2511832,184370,784,1850845,660987,935745,914794,306,10417,2501415,,282,220105,858413,772045,1850845
12-05-2021,Uttarakhand,2546600,141970,634,1880013,666587,952583,927115,315,11296,2535304,,283,239366,865391,774943,1880013
13-05-2021,Uttarakhand,2578678,137820,624,1907366,671312,968309,938736,321,13800,2564878,,284,258595,871118,777318,1907366
14-05-2021,Uttarakhand,2613490,156830,737,1937336,676154,984853,952148,335,21675,2591815,,284,281211,876184,779586,1937336
15-05-2021,Uttarakhand,2645339,162790,734,1964930,680409,1000126,964446,358,30551,2614788,,284,303012,880300,781246,1964930
16-05-2021,Uttarakhand,2663086,113681,395,1982530,680556,1009866,972302,362,37474,2625612,,285,318759,881693,781695,1982530
17-05-2021,Uttarakhand,2691931,124376,592,2011224,680707,1025882,984971,371,44935,2646996,,285,343118,884858,782846,2011224
18-05-2021,Uttarakhand,2715141,106312,595,2034375,680766,1039011,994975,389,50188,2664953,,285,363343,887067,783551,2034375
19-05-2021,Uttarakhand,2727448,62604,378,2046650,680798,1046039,1000217,394,52181,2675267,,286,373967,888280,783980,2046650
20-05-2021,Uttarakhand,2744103,77956,496,2063198,680905,1055337,1007458,403,54272,2689831,,286,389335,889142,784283,2063198
21-05-2021,Uttarakhand,2759084,84044,477,2078139,680945,1063725,1014004,410,55506,2703578,0,288,402944,890137,784610,2078139
22-05-2021,Uttarakhand,2772880,107332,566,2091853,681027,1071209,1020231,413,56585,2716295,0,288,413433,892504,785461,2091853
23-05-2021,Uttarakhand,2783836,87755,455,2102721,681115,1077073,1025231,417,57124,2726712,0,288,420525,895338,786399,2102721
24-05-2021,Uttarakhand,2807770,122163,713,2126366,681404,1089711,1036230,425,58138,2749632,0,288,435126,902021,788743,2126366
25-05-2021,Uttarakhand,2829587,121011,708,2147806,681781,1101314,1046053,439,59529,2770058,0,288,448200,908131,790987,2147806
26-05-2021,Uttarakhand,2838290,100432,515,2156373,681917,1105783,1050150,440,60259,2778031,0,288,452358,911331,792191,2156373
27-05-2021,Uttarakhand,2857400,105316,615,2175239,682161,1116177,1058614,448,61450,2795950,0,288,462641,917396,794692,2175239
28-05-2021,Uttarakhand,2875266,117543,620,2192644,682622,1125989,1066203,452,64031,2811235,0,289,471877,923234,797008,2192644
29-05-2021,Uttarakhand,2891355,104340,553,2208274,683081,1134533,1073285,456,68081,2823274,0,289,478707,929528,799504,2208274
30-05-2021,Uttarakhand,2901614,75816,396,2218328,683286,1139831,1078040,457,72443,2829171,0,289,482012,934032,801734,2218328
31-05-2021,Uttarakhand,2919103,86343,551,2235181,683922,1148414,1086307,460,78122,2840981,0,290,488158,941342,805116,2235181
01-06-2021,Uttarakhand,2932620,71729,485,2248175,684445,1155068,1092642,465,83441,2849179,0,291,492774,947027,807794,2248175
02-06-2021,Uttarakhand,2944942,69550,433,2259962,684980,1161149,1098344,469,87973,2856969,0,292,497065,952127,810178,2259962
03-06-2021,Uttarakhand,2962710,80147,529,2277114,685596,1170483,1106160,471,94546,2868164,0,292,503159,959465,813891,2277114
04-06-2021,Uttarakhand,2988289,85874,545,2301935,686354,1184274,1117178,483,100401,2887888,0,292,517192,966560,817547,2301935
05-06-2021,Uttarakhand,3025671,90680,584,2338708,686963,1205120,1133084,504,106545,2919126,0,293,543336,973428,821267,2338708
06-06-2021,Uttarakhand,3050222,65942,453,2362816,687406,1218610,1143693,513,110541,2939681,0,294,561466,977518,823128,2362816
07-06-2021,Uttarakhand,3084855,90685,644,2396288,688567,1236105,1159644,539,117801,2967054,0,294,582245,985652,827669,2396288
08-06-2021,Uttarakhand,3118649,85102,624,2429187,689462,1253703,1174928,556,125431,2993218,0,295,602603,993719,832114,2429187
09-06-2021,Uttarakhand,3156637,88023,594,2466183,690454,1273320,1192288,575,132588,3024049,0,295,629751,1000088,835534,2466183
10-06-2021,Uttarakhand,3207393,105010,653,2515957,691436,1300183,1215167,607,142111,3065282,0,295,667796,1007437,839879,2515957
11-06-2021,Uttarakhand,3250658,91779,562,2558034,692624,1322174,1235228,632,150438,3100220,0,296,698669,1014619,843866,2558034
12-06-2021,Uttarakhand,3285612,77604,429,2590812,694800,1340060,1250110,642,155964,3129648,0,298,721598,1020882,847418,2590812
13-06-2021,Uttarakhand,3320539,62139,337,2622029,698510,1357170,1264198,661,159776,3160763,0,298,746536,1024979,849574,2622029
14-06-2021,Uttarakhand,3377012,98270,584,2671224,705788,1383222,1287321,681,166784,3210228,0,298,785590,1031451,853188,2671224
15-06-2021,Uttarakhand,3419105,82084,492,2705277,713828,1401080,1303493,704,175439,3243666,0,298,811610,1036648,855979,2705277
16-06-2021,Uttarakhand,3444654,58197,386,2725505,719149,1411693,1313102,710,181875,3262779,0,298,826000,1040303,858142,2725505
17-06-2021,Uttarakhand,3477183,71310,432,2752271,724912,1426087,1325464,720,186337,3290846,0,298,844181,1045645,861349,2752271
18-06-2021,Uttarakhand,3515649,82368,522,2786799,728850,1444973,1341094,732,189344,3326305,0,298,870017,1051333,864301,2786799
19-06-2021,Uttarakhand,3541936,75115,444,2809750,732186,1457704,1351300,746,192539,3349397,0,298,887565,1054849,866144,2809750
20-06-2021,Uttarakhand,3556154,52463,226,2821983,734171,1464695,1356535,753,194170,3361984,0,298,897025,1056773,866973,2821983
21-06-2021,Uttarakhand,3676500,312798,707,2938547,737953,1528130,1409598,819,196058,3480442,0,298,1004130,1063021,869938,2938547
22-06-2021,Uttarakhand,3799085,301607,743,3056963,742122,1593122,1462972,869,197750,3601335,0,298,1113268,1069166,872876,3056963
23-06-2021,Uttarakhand,3922340,280817,708,3176320,746020,1658244,1517137,939,199599,3722741,0,299,1222165,1076290,876020,3176320
24-06-2021,Uttarakhand,4026451,251118,691,3274993,751458,1711046,1562968,979,200809,3825642,0,301,1311790,1082422,878796,3274993
25-06-2021,Uttarakhand,4124177,253018,651,3365897,758280,2158491,1964566,1120,202104,3922073,0,302,1561100,1325122,1237955,3365897
26-06-2021,Uttarakhand,4193872,162060,570,3425878,767994,2193954,1998770,1148,204157,3989715,0,303,1617038,1334103,1242731,3425878
27-06-2021,Uttarakhand,4214564,65076,237,3443111,771453,2204380,2009027,1157,206539,4008025,0,303,1633509,1336982,1244073,3443111
28-06-2021,Uttarakhand,4262996,136947,488,3478499,784497,2227339,2034486,1171,209537,4053459,0,306,1665304,1347576,1250116,3478499
29-06-2021,Uttarakhand,4339656,207242,555,3536398,803258,2268514,2069949,1193,218034,4121622,0,306,1717306,1364281,1258069,3536398
30-06-2021,Uttarakhand,4401789,156782,579,3579832,821957,2299080,2101490,1219,224605,4177184,0,307,1756148,1379806,1265835,3579832
01-07-2021,Uttarakhand,4446547,119377,536,3609832,836715,2320441,2124870,1236,231811,4214736,0,308,1782955,1391771,1271821,3609832
02-07-2021,Uttarakhand,4479447,91743,426,3631790,847657,2336141,2142064,1242,241475,4237972,0,308,1802515,1400853,1276079,3631790
03-07-2021,Uttarakhand,4527294,103352,380,3664283,863011,2360710,2165328,1256,253945,4273349,0,313,1831876,1413749,1281669,3664283
04-07-2021,Uttarakhand,4588910,140604,429,3710330,878580,2392299,2195328,1283,269819,4319091,0,313,1873323,1428217,1287370,3710330
05-07-2021,Uttarakhand,4687985,233130,760,3774218,913767,2438635,2248016,1334,288117,4399868,0,313,1929747,1456434,1301804,3774218
06-07-2021,Uttarakhand,4762569,186255,668,3821058,941511,2473723,2287475,1371,304319,4458250,0,315,1971063,1478283,1313223,3821058
