Updated On,State,TotalDosesAdministered,TotalSessionsConducted,TotalSites ,FirstDoseAdministered,SecondDoseAdministered,Male,Female,Transgender,Covaxin,CoviShield,SputnikV,AEFI,18_45_years,45_60_years,60_+_years,Total_Individuals_Vaccinated
16-03-2021,West Bengal,2818171,608310,2994,2400215,417956,1422806,977119,290,234263,2583908,,328,637601,876972,884944,2400215
17-03-2021,West Bengal,3121794,444160,2135,2688119,433675,1577709,1110077,333,254897,2866897,,341,645126,938148,1104140,2688119
18-03-2021,West Bengal,3260568,431000,2145,2808898,451670,1645672,1162885,341,264813,2995755,,349,653312,973162,1181717,2808898
19-03-2021,West Bengal,3561127,733370,3765,3086159,474968,1790533,1295254,372,281268,3279859,,374,662779,1052248,1370409,3086159
20-03-2021,West Bengal,3758013,466270,2372,3263416,494597,1882984,1380032,400,301990,3456023,,395,671633,1111828,1479223,3263416
21-03-2021,West Bengal,3791481,157450,759,3294084,497397,1898738,1394941,405,307460,3484021,,397,673305,1123335,1496711,3294084
22-03-2021,West Bengal,4029095,597271,3402,3505433,523662,2010192,1494805,436,333598,3695497,,400,682468,1183291,1638937,3505433
23-03-2021,West Bengal,4284851,466180,2652,3727569,557282,2126625,1600493,451,371779,3913072,,470,694023,1256628,1776170,3727569
24-03-2021,West Bengal,4428925,338660,1800,3850626,578299,2192309,1657860,457,396831,4032094,,496,701264,1298082,1850519,3850626
25-03-2021,West Bengal,4577280,367690,1996,3976580,600700,2261811,1714302,467,418638,4158642,,534,708631,1337743,1929437,3976580
26-03-2021,West Bengal,4883468,627390,3806,4261110,622358,2405782,1854839,489,446642,4436826,,565,716714,1437469,2106148,4261110
27-03-2021,West Bengal,5082386,484750,2899,4448531,633855,2499459,1948561,511,463250,4619136,,584,722285,1514568,2210891,4448531
28-03-2021,West Bengal,5087735,96180,533,4453685,634050,2502055,1951119,511,463391,4624344,,584,722454,1516801,2213643,4453685
29-03-2021,West Bengal,5110946,188205,1061,4475456,635490,2513314,1961626,516,467291,4643655,,602,723395,1525921,2225353,4475456
30-03-2021,West Bengal,5323718,650031,3453,4671332,652386,2613576,2057218,538,486308,4837410,,626,729498,1595242,2345801,4671332
31-03-2021,West Bengal,5467439,521560,2608,4798424,669015,2676605,2121264,555,502999,4964440,,672,733567,1646753,2417309,4798424
01-04-2021,West Bengal,5614451,527960,2701,4932709,681742,2742833,2189310,566,515820,5098631,,686,737390,1728144,2466374,4932709
02-04-2021,West Bengal,5796984,476940,2498,5103078,693906,2825920,2276577,581,530967,5266017,,701,741155,1837066,2524047,5103078
03-04-2021,West Bengal,5967900,564020,3077,5260046,707854,2902501,2356946,599,543432,5424468,,709,744699,1937086,2577444,5260046
04-04-2021,West Bengal,6148158,453950,2309,5427490,720668,2985675,2441198,617,556008,5592150,,737,747850,2051440,2627379,5427490
05-04-2021,West Bengal,6396475,831225,4350,5657151,739324,3097050,2559453,648,572148,5824327,,743,748892,2197559,2709880,5657151
06-04-2021,West Bengal,6639763,701330,3630,5881580,758183,3204767,2676149,664,589806,6049957,,749,749699,2345417,2785641,5881580
07-04-2021,West Bengal,7020613,534293,2733,6222811,797802,3370530,2851586,695,626747,6393866,,789,751226,2570448,2900312,6222811
08-04-2021,West Bengal,7311686,662418,3304,6465014,846672,3492756,2971542,716,663838,6647848,,828,753266,2730921,2980002,6465014
09-04-2021,West Bengal,7673269,764510,4195,6783892,889377,3647663,3135469,760,710993,6962276,,869,754956,2941770,3086335,6783892
10-04-2021,West Bengal,7891168,516270,2808,6972586,918582,3741766,3230032,788,753017,7138151,,908,756105,3069839,3145811,6972586
11-04-2021,West Bengal,7982276,607140,3113,7051017,931259,3782206,3268014,797,776483,7205793,,913,757054,3122325,3170808,7051017
12-04-2021,West Bengal,8224788,781951,4132,7241680,983108,3877922,3362932,826,835631,7389157,,932,759141,3245849,3235858,7241680
13-04-2021,West Bengal,8345059,567710,2976,7328009,1017050,3926414,3400769,826,872814,7472245,,946,761383,3301863,3263928,7328009
14-04-2021,West Bengal,8442892,494751,2493,7398413,1044479,3964545,3433037,831,896362,7546530,,956,763554,3348262,3285761,7398413
15-04-2021,West Bengal,8468805,647120,3331,7415379,1053426,3974353,3440191,835,903609,7565196,,959,764252,3359541,3290749,7415379
16-04-2021,West Bengal,8608782,615570,3320,7499090,1109692,4018864,3479382,844,930115,7678667,,968,766666,3412658,3318930,7499090
17-04-2021,West Bengal,8739716,366910,1943,7577053,1162663,4060679,3515521,853,953764,7785952,,976,768339,3463694,3344181,7577053
18-04-2021,West Bengal,8764150,489171,2889,7593056,1171094,4069772,3522428,856,960216,7803934,,979,768887,3474490,3348840,7593056
19-04-2021,West Bengal,8976141,604585,3414,7701111,1275030,4128110,3572137,864,986681,7989460,,986,773292,3541915,3385062,7701111
20-04-2021,West Bengal,9209694,490740,2747,7830594,1379100,4198697,3631015,882,1007847,8201847,,992,778620,3623624,3427503,7830594
21-04-2021,West Bengal,9396068,459350,2437,7934464,1461604,4254741,3678829,894,1026194,8369874,,998,781805,3689118,3462687,7934464
22-04-2021,West Bengal,9558233,644920,3770,8024582,1533651,4303341,3720337,904,1041310,8516923,,1002,784646,3746873,3492205,8024582
23-04-2021,West Bengal,9780255,622920,3552,8139244,1641011,4365184,3773140,920,1060048,8720207,,1004,789426,3818947,3530013,8139244
24-04-2021,West Bengal,9938423,336400,1827,8227116,1711307,4413135,3813048,933,1075009,8863414,,1008,793476,3875587,3557189,8227116
25-04-2021,West Bengal,9969252,210925,1187,8243729,1725523,4422524,3820268,937,1078588,8890664,,1009,794338,3886240,3562287,8243729
26-04-2021,West Bengal,10228994,618981,3567,8363314,1865680,4487398,3874965,951,1096741,9132253,,1012,799183,3961314,3601948,8363314
27-04-2021,West Bengal,10437665,534313,2966,8467133,1970532,4544342,3921834,957,1119849,9317816,,1015,1046090,3785316,3634851,8467133
28-04-2021,West Bengal,10630769,437450,2345,8539976,2090793,4584349,3954665,962,1136359,9494410,,1019,1051081,3828784,3659225,8539976
29-04-2021,West Bengal,10781641,383054,2157,8596240,2185401,4614983,3980290,967,1150817,9630824,,1020,1054617,3862436,3678369,8596240
30-04-2021,West Bengal,10971948,500781,2764,8662227,2309721,4650922,4010327,978,1171721,9800227,,1021,1059054,3902058,3700267,8662227
01-05-2021,West Bengal,11058053,288958,1743,8689947,2368106,4666310,4022654,983,1177124,9880929,,1021,1061477,3918301,3709317,8689947
02-05-2021,West Bengal,11066324,180250,1029,8692844,2373480,4667838,4024023,983,1177581,9888743,,1021,1059933,3921762,3710400,8692844
03-05-2021,West Bengal,11256097,510205,2952,8725020,2531077,4685336,4038697,987,1191584,10064513,,1024,1063836,3937143,3723296,8725020
04-05-2021,West Bengal,11409897,410075,2377,8750404,2659493,4699482,4049922,1000,1204436,10205461,,1027,1067400,3948089,3734160,8750404
05-05-2021,West Bengal,11506727,289035,1626,8764695,2742032,4707646,4056047,1002,1214446,10292281,,1028,1071291,3953484,3739165,8764695
06-05-2021,West Bengal,11594723,301115,1674,8777268,2817455,4715269,4060997,1002,1226791,10367932,,1028,1075945,3957788,3742778,8777268
07-05-2021,West Bengal,11839680,512145,2940,8808010,3031670,4732280,4074724,1006,1246103,10593577,,1030,1081789,3969145,3756318,8808010
08-05-2021,West Bengal,11952404,341101,2027,8823763,3128641,4741259,4081493,1011,1260663,10691741,,1031,1086523,3974768,3761713,8823763
09-05-2021,West Bengal,11963861,100240,557,8825922,3137939,4742419,4082492,1011,1262952,10700909,,1031,1086941,3975640,3762582,8825922
10-05-2021,West Bengal,12108661,342346,2009,8844778,3263883,4752862,4090901,1015,1293385,10815276,,1032,1091815,3982739,3769369,8844778
11-05-2021,West Bengal,12226878,273890,1560,8862487,3364391,4763561,4097909,1017,1325190,10901688,,1033,1097962,3989225,3774405,8862487
12-05-2021,West Bengal,12408070,290220,1693,8890679,3517391,4779701,4109958,1020,1350173,11057897,,1033,1105785,4000085,3783870,8890679
13-05-2021,West Bengal,12562690,252139,1473,8916777,3645913,4795315,4120439,1023,1372847,11189843,,1034,1114665,4009986,3791146,8916777
14-05-2021,West Bengal,12609247,207632,1145,8929070,3680177,4803397,4124650,1023,1381997,11227250,,1034,1121235,4013500,3793337,8929070
15-05-2021,West Bengal,12673069,265500,1535,8955081,3717988,4820673,4133379,1029,1395568,11277501,,1034,1132809,4023691,3797563,8955081
16-05-2021,West Bengal,12678649,72268,365,8958736,3719913,4823003,4134704,1029,1396978,11281671,,1034,1134741,4024905,3798066,8958736
17-05-2021,West Bengal,12741310,379622,1730,9001376,3739934,4851954,4148384,1038,1421802,11319508,,1036,1151678,4043894,3804758,9001376
18-05-2021,West Bengal,12805341,295766,1313,9046876,3758465,4882518,4163312,1046,1445968,11359373,,1037,1168535,4064819,3812446,9046876
19-05-2021,West Bengal,12869283,277573,1209,9095356,3773927,4914829,4179468,1059,1466740,11402543,,1057,1188120,4085502,3820633,9095356
20-05-2021,West Bengal,12933777,277524,1189,9145955,3787822,4948615,4196276,1064,1484996,11448781,,1057,1208802,4106355,3829661,9145955
21-05-2021,West Bengal,13005623,342361,1456,9202262,3803361,4987692,4213499,1071,1503944,11501679,0,1070,1238617,4125116,3837362,9202262
22-05-2021,West Bengal,13088982,348215,1453,9274004,3814978,5038932,4233990,1082,1521690,11567292,0,1070,1281557,4145937,3845323,9274004
23-05-2021,West Bengal,13144472,167930,745,9329018,3815454,5077002,4250930,1086,1524873,11619599,0,1070,1321251,4157416,3849138,9329018
24-05-2021,West Bengal,13334185,586868,2253,9506802,3827383,5198600,4307101,1101,1547037,11787148,0,1069,1439321,4200304,3865878,9506802
25-05-2021,West Bengal,13492633,571187,2118,9656735,3835898,5299015,4356592,1128,1562731,11929902,0,1074,1545825,4232121,3877399,9656735
26-05-2021,West Bengal,13555378,384001,1517,9718236,3837142,5339855,4377247,1134,1565037,11990341,0,1076,1592066,4243391,3881369,9718236
27-05-2021,West Bengal,13729739,580752,1952,9887152,3842587,5451575,4434426,1151,1576360,12153379,0,1079,1715667,4276463,3893536,9887152
28-05-2021,West Bengal,13993297,724436,2353,10141006,3852291,5615050,4524749,1207,1596844,12396453,0,1080,1906181,4323513,3909678,10141006
29-05-2021,West Bengal,14271067,706501,2235,10407006,3864061,5782515,4623251,1240,1619084,12651983,0,1094,2099491,4377022,3928680,10407006
30-05-2021,West Bengal,14412969,381157,1170,10547015,3865954,5871662,4674095,1258,1625834,12787135,0,1100,2202804,4404252,3938023,10547015
31-05-2021,West Bengal,14718135,839415,2511,10838457,3879678,6050228,4786796,1433,1650999,13067136,0,1144,2402085,4469534,3964698,10838457
01-06-2021,West Bengal,14969157,781523,2249,11075394,3893763,6194489,4879421,1484,1677903,13291254,0,1148,2552320,4530593,3990153,11075394
02-06-2021,West Bengal,15186412,790334,1988,11283299,3903113,6317601,4964153,1545,1693274,13493138,0,1184,2659657,4602658,4018278,11283299
03-06-2021,West Bengal,15430414,803979,2104,11514760,3915654,6452599,5060564,1597,1712330,13718084,0,1208,2762061,4691823,4057835,11514760
04-06-2021,West Bengal,15726490,937852,2500,11795260,3931230,6615547,5178013,1700,1749972,13976518,0,1210,2874071,4810523,4107132,11795260
05-06-2021,West Bengal,16031152,981547,2517,12090072,3941080,6784722,5303588,1762,1806377,14224775,0,1211,2999339,4927157,4159589,12090072
06-06-2021,West Bengal,16149949,479793,1016,12206706,3943243,6851075,5353848,1783,1825771,14324178,0,1214,3058135,4968447,4175911,12206706
07-06-2021,West Bengal,16453879,1062959,2523,12492937,3960942,7014307,5476794,1836,1878776,14575103,0,1223,3174029,5087762,4226545,12492937
08-06-2021,West Bengal,16717047,1026098,2358,12742698,3974349,7157564,5583273,1861,1931666,14785235,146,1238,3290866,5179191,4267590,12742698
09-06-2021,West Bengal,16940919,887059,1952,12954543,3986376,7279703,5672936,1904,1985988,14954421,510,1254,3411008,5242947,4294961,12954543
10-06-2021,West Bengal,17139018,855255,1840,13143096,3995922,7389954,5751217,1925,2038350,15099782,886,1255,3522931,5294448,4319567,13143096
11-06-2021,West Bengal,17382133,938204,2285,13364800,4017333,7515581,5847267,1952,2098522,15282450,1161,1256,3636199,5368568,4353373,13364800
12-06-2021,West Bengal,17600439,863985,1955,13561818,4038621,7626393,5933433,1992,2140344,15458867,1228,1258,3722829,5445165,4386672,13561818
13-06-2021,West Bengal,17657700,341937,626,13615740,4041960,7655594,5958148,1998,2149099,15507373,1228,1260,3751825,5461751,4394810,13615740
14-06-2021,West Bengal,17867444,894838,2027,13798076,4069368,7758272,6037791,2013,2193516,15672624,1304,1267,3825970,5535198,4429118,13798076
15-06-2021,West Bengal,18123718,920508,2316,14013951,4109767,7880231,6131668,2052,2238508,15883827,1383,1268,3902985,5632691,4470082,14013951
16-06-2021,West Bengal,18249050,689858,1399,14127403,4121647,7946848,6178486,2069,2261779,15985720,1551,1268,3961701,5671448,4485809,14127403
17-06-2021,West Bengal,18431037,800776,1754,14282047,4148990,8037832,6242130,2085,2295128,16134246,1663,1298,4032176,5731566,4509595,14282047
18-06-2021,West Bengal,18645621,908002,2128,14455315,4190306,8137548,6315632,2135,2331892,16311944,1785,1298,4103319,5803254,4539724,14455315
19-06-2021,West Bengal,18937419,995573,2406,14677149,4260270,8261718,6413230,2201,2362542,16572939,1938,1304,4185341,5901558,4580784,14677149
20-06-2021,West Bengal,19010947,385941,732,14736671,4274276,8294637,6439825,2209,2364785,16644224,1938,1304,4205886,5928402,4592780,14736671
21-06-2021,West Bengal,19349842,1144223,2645,14997560,4352282,8436127,6559127,2306,2390176,16957510,2156,1305,4301083,6043269,4643178,14997560
22-06-2021,West Bengal,19667535,1019996,2390,15251854,4415681,8573653,6675856,2345,2411607,17253543,2385,1317,4428948,6131404,4681095,15251854
23-06-2021,West Bengal,20022881,1065896,2511,15536230,4486651,8729509,6804328,2393,2430079,17590248,2554,1319,4599920,6208593,4716977,15536230
24-06-2021,West Bengal,20352923,1073696,2260,15798841,4554082,8871378,6925019,2444,2453856,17896337,2730,1358,4763216,6277522,4747065,15798841
25-06-2021,West Bengal,20739972,1225381,2744,16098954,4641018,11656915,9080212,2845,2480444,18256536,2992,1368,5875034,7930339,6934599,16098954
26-06-2021,West Bengal,21043842,1073314,2192,16320306,4723536,11815468,9225486,2888,2505880,18534735,3227,1399,6037547,8021981,6984314,16320306
27-06-2021,West Bengal,21128717,392769,735,16382560,4746157,11858394,9267424,2899,2518472,18607018,3227,1405,6084504,8046639,6997574,16382560
28-06-2021,West Bengal,21427071,1013931,2003,16563389,4863682,12005560,9418570,2941,2559818,18863698,3555,1411,6216006,8153426,7057639,16563389
29-06-2021,West Bengal,21711965,1010959,2126,16729378,4982587,12146832,9562159,2974,2621541,19086502,3922,1429,6342512,8257176,7112277,16729378
30-06-2021,West Bengal,21889622,790786,1544,16833029,5056593,12236044,9650559,3019,2664980,19220094,4548,1437,6424210,8319206,7146206,16833029
01-07-2021,West Bengal,22009840,589607,1066,16900071,5109769,12296605,9710198,3037,2692776,19311955,5109,1442,6477845,8362298,7169697,16900071
02-07-2021,West Bengal,22319689,957980,2205,17019095,5300594,12451181,9865416,3092,2738013,19576144,5532,1443,6577682,8498028,7243979,17019095
03-07-2021,West Bengal,22591117,884093,1893,17135494,5455623,12587327,10000643,3147,2784951,19800258,5908,1452,6677615,8609491,7304011,17135494
04-07-2021,West Bengal,22660276,308516,619,17165989,5494287,12621040,10036073,3163,2795670,19858613,5993,1460,6704575,8636930,7318771,17165989
05-07-2021,West Bengal,22960000,832804,2065,17285927,5674073,12772010,10184778,3212,2852363,20101114,6523,1462,6814922,8760232,7384846,17285927
06-07-2021,West Bengal,23205213,741696,1820,17382673,5822540,12896789,10305169,3255,2904258,20293503,7452,1470,6906592,8860405,7438216,17382673
